a	@
a	@i
aa	A:
aalborg	A: l b O: g
aalto	A: l t @u
aaron	E r\ @ n
ab	{ b
abadan	a b a d a n
abandon	@ b { n d @ n
abandonment	@ b { n d @ n m @ n t
abbey	{ b i
abbots	{ b @ t s
abbreviation	@ b r\ i: v i @i S @ n
abby	{ b i
abc	@i b i: s i:
abd	@i b i: d i:
abdominal	{ b d Q m @ n @ l
abducted	{ b d a k t @ d
abdul	a b d U l
abdul	{ b d U l
abednego	@ b E d n i g @u
abel	a b E l
abel	@i b @ l
abelian	@ b i: l i@ n
aberration	{ b @ r\ @i S @ n
abjad	{ b d_0Z { d
able	@i b @ l
abortion	@ b O: S @ n
about	@ b au t
above	@ b a v
abraham	@i b r\ @ h\ { m
abram	@i b r\ { m
abroad	@ b r\ O: d
absolute	{ b s @ l u: t
absorb	{ b s O: b
absorbed	{ b s O: b d
absorbing	{ b s O: b i N
absorption	{ b s O: p S @ n
absorptions	{ b s O: p S @ n z
abstract	{ b s t r\ { k t
absurdum	{ b s 3: d m
abu	A: b U
abundant	@ b a n d @ n t
abuse	@ b j u: s
abuses	@ b j u: s @ s
academic	{ k @ d E m i k
academics	{ k @ d E m i k s
academy	@ k { d @ m i
acceded	@ k s i: d @ d
accelerators	{ k s E l @ r\ @i t @ z
acceptance	{ k s E p t @ n s
accepted	{ k s E p t @ d
access	{ k s E s
accessdate	{ k s E s d @i t
accident	{ k s @ d @ n t
accidental	{ k s @ d E n t @ l
accidentally	{ k s @ d E n t @ l i
accidents	{ k s @ d @ n t s
acclaim	@ k l @i m
according	@ k O: d i N
accordion	@ k O: d i@ n
accords	@ k O: d z
account	@ k au n t
accountability	@ k @u n t @ b @ l @ t i
accounted	@ k au n t @ d
accounts	@ k au n t s
accumulated	@ k j u: m j U l @i t @ d
accurate	{ k j @ r\ @ t
accusations	{ k j u: z @i S @ n z
accused	@ k j u: z d
achaemenid	@ k i m @ n @ d
achieved	@ tS i: v d
achievement	@ tS i: v m @ n t
acid	{ s @ d
acidic	@ s i d i k
acids	{ s @ d z
ackerman	{ k @ m @ n
acknowledged	{ k n Q l i d_0Z d
acknowledging	{ k n Q l i d_0Z i N
acoustic	@ k U s t i k
acquired	@ k w ai @ d
acquisitions	{ k w @ z i S @ n z
acre	@i k @ r\
acropolis	@ k r\ Q p @ l @ s
across	@ k r\ Q s
acrostic	@ k r\ Q s t i k
act	{ k t
acte	{ k t
acting	{ k t i N
action	{ k S @ n
actions	{ k S @ n z
activation	{ k t @ v @i S @ n
active	{ k t @ v
actively	{ k t @ v l i
activists	{ k t @ v @ s t s
activities	{ k t @ v @ t i z
activity	{ k t @ v @ t i
actor	{ k t @ r\
actors	{ k t @ z
actress	{ k t r\ @ s
acts	{ k t s
actual	{ k tS u@ l
actually	{ k tS U l i
ad	{ d
ada	A: d a
ada	@i d a
adam	{ d @ m
adams	{ d @ m z
adams's	{ d @ m s z
adaptation	{ d { p t @i S @ n
adapted	@ d { p t @ d
adaptive	@ d { p t @ v
adb	@i d i: b i:
add	{ d
added	{ d @ d
additionally	@ d i S @ n @ l i
additive	{ d @ t @ v
address	@ d r\ E s
addresses	@ d r\ E s @ s
adelaide	{ d @ l @i d
adeleide	{ d @ l @i d
adenosine	{ d i n @u s i: n
adequate	{ d @ k w @ t
adhd	@i d i: @i tS d i:
adiabats	{ d i@ b { t s
adjacent	@ d_0Z @i s @ n t
adjective	{ d_0Z E k t @ v
adjectives	{ d_0Z E k t @ v z
adjustment	@ d_0Z a s t m @ n t
administer	{ d m @ n @ s t @ r\
administered	{ d m @ n @ s t @ d
administration	{ d m @ n @ s t r\ @i S @ n
administrative	{ d m @ n @ s t r\ @ t @ v
admiral	{ d m @ r\ @ l
admirals	{ d m @ r\ @ l z
admission	{ d m i S @ n
adobe	@ d @u b
adobe	@ d @u b i
adolf	{ d Q l f
adopted	@ d Q p t @ d
adrenal	@ d r\ i: n @ l
adrian	@i d r\ i@ n
adult	{ d a l t
advance	@ d v A: n s
advanced	@ d v A: n s t
advantage	@ d v A: n t i d_0Z
adventure	@ d v E n tS @ r\
adverse	{ d v 3: s
adviser	@ d v ai z @ r\
advisor	@ d v ai z @ r\
advocated	{ d v @ k @i t @ d
advocates	{ d v @ k @ t s
aeneid	@ n i@ d
aeolic	i@ O: l i k
aerial	e@ r\ i@ l
aeronautica	e@ r\ @ n O: t i k @
aerophones	e@ r\ @u f @u n z
aerospace	e@ r\ @u s p @i s
aes	@i i: E s
aesa	a i: s @
aesa	@i i: E s @i
aetolians	i: t @u l i@ n z
afc	@i E f s i:
affair	@ f e@ r\
affairs	@ f e@ z
affecting	@ f E k t i N
affects	@ f E k t s
affirms	@ f 3: m z
afforded	@ f O: d @ d
afghan	{ f g { n
afghanistan	{ f g { n i s t { n
afghans	{ f g { n z
afl	@i E f { l
africa	{ f r\ i k @
african	{ f r\ i k @ n
africans	{ f r\ i k @ n z
afrikaans	A: f r\ i k A: n s
afrikaans	{ f r\ i k A: n s
afroasiatic	{ f r\ @u @i z i { t i k
after	A: f t @ r\
aga	@ g @
agarose	@ g @ r\ @u z
agassi	@ g { s i
age	@i d_0Z
agencies	@i d_0Z @ n s i z
agency	@i d_0Z @ n s i
agent	@i d_0Z @ n t
agents	@i d_0Z @ n t s
ages	@i d_0Z @ z
aggressus	@ g r\ E s @ s
agile	{ d_0Z ai l
aging	@i d_0Z i N
agnathan	{ g n @i T @ n
agni	{ g n i
agnostics	{ g n Q s t i k s
ago	@ g @u
agoa	@ g @u a
agreed	@ g r\ i: d
agreeing	@ g r\ i: i N
agreement	@ g r\ i: m @ n t
agreements	@ g r\ i: m @ n t s
agricola	{ g r\ i k @ l @
agricultural	{ g r\ i k a l tS @ r\ @ l
agriculture	{ g r\ i k a l tS @ r\
agrippa	@ g r\ @ p a
aground	@ g r\ au n d
ahmad	a k m a t
ahmed	a k m E t
aid	@i d
aide	@i d
aikin	ai k @ n
aina	ai n a
air	e@ r\
airborne	e@ b O: n
aircraft	e@ k r\ A: f t
aires	e@ z
aires	@i r\ i: z
airlines	e@ l ai n z
airmass	e@ m @ s
airport	e@ p O: t
airports	e@ p O: t s
airship	e@ S @ p
airways	e@ w @i z
akitu	@ k i t u:
al	{ l
alabama	{ l @ b { m @
alabaster	{ l @ b { s t @ r\
alacrity	@ l { k r\ i t i
alamos	{ l @ m @u z
alan	{ l @ n
alaska	@ l { s k @
alatricity	{ l @ t r\ @ s @ t i
albanian	{ l b @i n i@ n
albans	{ l b @ n z
albeit	O: l b i: @ t
albemuth	{ l b @ m @ T
albert	{ l b @ t
alberti	{ l b 3: t i
alberton	{ l b 3: t @ n
albi	{ l b i
albion	{ l b ai n
album	{ l b @ m
albums	{ l b @ m z
alby's	{ l b i z
alchemists	{ l k @ m @ s t s
alchemy	{ l k @ m i
alcohol	{ l k @ h\ Q l
alcohols	{ l k @ h\ Q l z
alcott	{ l k Q t
alderley	O: l d @ l i
aldrin	{ l d r\ @ n
alenia	@ l i: n i@
ales	@i l z
alexander	{ l @ g z A: n d @ r\
alexander	{ l @ g z { n d @ r\
alexandra	{ l @ g z A: n d r\ @
alexandra	{ l @ g z { n d r\ @
alexandria	{ l @ g z A: n d r\ i@
alexandria	{ l @ g z { n d r\ i@
alexandrian	{ l @ g z A: n d r\ i@ n
alexandrian	{ l @ g z { n d r\ i@ n
alexius	@ l E k s i@ s
alfred	{ l f r\ @ d
algebra	{ l d_0Z @ b r\ @
algebraic	{ l d_0Z @ b r\ @i i k
algebraically	{ l d_0Z @ b r\ @i k l i
algeria	{ l d_0Z i@ r\ i@
algol	{ l g @ l
algorithmic	{ l g @ r\ @ T m i k
algorithms	{ l g @ r\ @ T @ m z
ali	{ l i
alice	{ l @ s
alice's	{ l @ s @ s
aliens	@i l i@ n z
alkali	{ l k @ l ai
alkaline	{ l k @ l ai n
all	O: l
allah	A: l a
allan	{ l @ n
alleged	@ l E d_0Z d
allemansdrift	a l @ m a n s d r\ @ f t
allen	{ l @ n
allergies	{ l @ d_0Z i z
alley	{ l i
alliance	@ l ai @ n s
allied	{ l ai d
allies	{ l ai z
allman	O: l m @ n
allocation	{ l @ k @i S @ n
allocations	{ l @ k @i S @ n z
allouni	@ l au u: n i
allow	@ l au
allowed	@ l au d
allowing	@ l au i N
allows	@ l au z
ally	{ l ai
alongside	@ l Q N s ai d
alpha	{ l f @
alphabet	{ l f @ b E t
alps	{ l p s
already	O: l r\ E d i
also	O: l s @u
alternate	O: l t 3: n @ t
alternative	O: l t 3: n @ t @ v
although	O: l D @u
altitude	{ l t i t j u: d
alto	{ l t @u
alumni	@ l a m n ai
alums	@ l @ m z
alvar	{ l v A: r\
alvin	{ l v @ n
amanullah	a m a n j U l a
amateur	{ m @ t @ r\
ambassador	{ m b { s @ d @ r\
ambassadors	{ m b { s @ d @ z
ambato	{ m b A: t @u
amber	{ m b @ r\
ambiguous	{ m b i g j u@ s
ambitious	{ m b i S @ s
ambitiously	{ m b i S @ s l i
america	@ m E r\ i k @
american	@ m E r\ i k @ n
americans	@ m E r\ i k @ n z
amiga	a m i: g @
amino	a m i: n @u
ammonia	@ m @u n i@
among	@ m a N
amorphous	@ m O: f @ s
amounts	@ m au n t s
amplification	{ m p l i f i k @i S @ n
amplifiers	{ m p l @ f ai @ z
amusement	@ m j u: z m @ n t
amyotrophic	@i m i @u t r\ Q f i k
an	{ n
analog	{ n @ l Q g
analyses	@ n { l @ s i: z
analysis	@ n { l @ s @ s
analysts	{ n @ l @ s t s
analytic	{ n @ l @ t i k
anarchism	{ n A: k @ z @ m
anarchist	{ n A: k @ s t
anarchistes	{ n A: k @ s t s
anarchists	{ n A: k @ s t s
anastasio	{ n @ s t @i s i @u
anatolian	{ n @ t @u l i@ n
anatomy	@ n { t @ m i
anc	@i E n s i:
ancestor	{ n s E s t @ r\
ancestry	{ n s E s t r\ i
anchor	{ N k @ r\
ancient	@i n S @ n t
and	{ n d
andalusian	{ n d @ l u: S i@ n
andechs	{ n d E k s
andersen	{ n d @ s @ n
anderson	{ n d @ s @ n
andorra	{ n d O: r\ @
andreas	{ n d r\ @i @ s
andrew	{ n d r\ u:
andrey	{ n d r\ i
andro	{ n d r\ @u
androids	{ n d r\ Oi d z
andy	{ n d i
anesthetic	{ n @ s T E t i k
aneurysm	{ n j u: r\ @ z @ m
ang	@i E n d_0Z i:
angeles	{ n d_0Z @ l i: z
angeli	{ n d_0Z @ l i
angelo	{ n d_0Z @ l @u
angels	@i n d_0Z @ l z
angiosperm	{ n d_0Z i @u s p 3: m
angle	{ N g @ l
angled	{ N g @ l d
anglican	{ N g l i k @ n
anglo	{ N g l @u
anglorum	{ N g l @ r\ @ m
angola	{ N g @u l @
angolan	{ N g @u l @ n
anguilla	{ N g w @ l @
angular	{ N g j U l @ r\
animal	{ n @ m @ l
animals	{ n @ m @ l z
animated	{ n @ m @i t @ d
animation	{ n @ m @i S @ n
anime	{ n ai m
anisotropy	{ n @ s @ t r\ @ p i
ankara	{ N k @ r\ A:
anna	{ n @
annalen	{ n @ l @ n
annan	{ n @ n
annandale	{ n { n d @i l
annexed	@ n E k s t
announced	@ n au n s t
announcement	@ n au n s m @ n t
announcements	@ n au n s m @ n t s
announcer	@ n au n s @ r\
annual	{ n j u@ l
annually	{ n j u@ l i
another	@ n a D @ r\
ansbach	{ n z b { k
ansi	{ n s i
antagonists	{ n t { g @ n @ s t s
antarctic	{ n t A: k t i k
antarctica	{ n t A: k t i k @
anthological	{ n T @ l Q d_0Z i k @ l
anthony	{ n t @ n i
anthropological	{ n T r\ @ p @ l Q d_0Z i k @ l
anthropologists	{ n T r\ @ p Q l @ d_0Z @ s t s
anthropology	{ n T r\ @ p Q l @ d_0Z i
anthropomorphic	{ n T r\ @ p @u m O: f i k
anti	{ n t i
antibodies	{ n t i b Q d i z
anticorruption	{ n t i k @ r\ a p S @ n
antigua	{ n t i: g @
antilles	{ n t @ l z
antiplatelet	{ n t i p l @i t l @ t
antipope	{ n t i p @u p
antiquity	{ n t i k w @ t i
anton	{ n t Q n
anxiety	{ N z ai @ t i
any	E n i
aoraki	au r\ A: k i
aortic	@i O: t i k
apa	@i p a
apa	@i p i: @i
apache	@ p { tS i
apartheid	@ p A: t ai t
apec	@i p E k
apec	@i p i: i: s i:
aperture	{ p @ tS @ r\
apex	@i p E k s
aphrodite	{ f r\ @ d ai t
api	@i p i: ai
apl	@i p i: { l
apocrypha	@ p Q k r\ @ f @
apollo	@ p Q l @u
apoptosis	{ p Q p t @u s @ s
apostolic	{ p @ s t Q l i k
appalachian	{ p @ l @i S @ n
apparent	@ p { r\ @ n t
apparently	@ p { r\ @ n t l i
appeals	@ p i: l z
appear	@ p i@ r\
appearance	@ p i@ r\ @ n s
appearances	@ p i@ r\ @ n s @ s
appeared	@ p i@ d
appears	@ p i@ z
appellate	@ p { l @ t
apple	{ p @ l
application	{ p l i k @i S @ n
applications	{ p l i k @i S @ n z
applied	@ p l ai d
apply	@ p l ai
applying	@ p l ai i N
appoint	@ p Oi n t
appointed	@ p Oi n t @ d
appointments	@ p Oi n t m @ n t s
appoints	@ p Oi n t s
appomattox	{ p @ m { t @ k s
appraisals	@ p r\ @i z @ l z
appreciable	@ p r\ i: S @ b @ l
approach	@ p r\ @u tS
approaches	@ p r\ @u tS @ z
appropriate	@ p r\ @u p r\ i@ t
approval	@ p r\ u: v @ l
approximately	@ p r\ Q k s @ m @ t l i
approximations	@ p r\ Q k s @ m @i S @ n z
apricot	@i p r\ i k Q t
april	@i p r\ @ l
aquinas	@ k i: n @ z
ar	@i A: r\
arab	{ r\ @ b
arabia	@ r\ @i b i@
arabian	@ r\ @i b i@ n
arabic	{ r\ @ b i k
arabs	{ r\ @ b z
aramaic	{ r\ @ m @i i k
arbitrary	A: b @ t r\ @ r\ i
arbor	A: b @ r\
arcade	A: k @i d
archaeological	A: k i@ l Q d_0Z i k @ l
archaeology	A: k i Q l @ d_0Z i
archbishops	A: tS b i S @ p s
archdiocese	A: tS d ai @ s @ s
archduke	A: tS d j u: k
archelaus	A: k @ l @i @ s
archeological	A: k i@ l Q d_0Z i k @ l
archeology	A: k i Q l @ d_0Z i
archer	A: tS @ r\
archers	A: tS @ z
architect	A: k i t E k t
architects	A: k i t E k t s
architectural	A: k i t E k tS @ r\ @ l
architecture	A: k i t E k tS @ r\
architectures	A: k i t E k tS @ z
archives	A: k ai v z
archiving	A: k i v i N
archosaur	A: k @u s O: r\
arcs	A: k s
arctic	A: k t i k
are	A: r\
area	e@ r\ i@
areas	e@ r\ i@ z
arena	@ r\ i: n @
argentina	A: d_0Z @ n t i: n @
argentine	A: d_0Z @ n t ai n
argentine	A: d_0Z @ n t i: n
argon	A: g Q n
argot	A: g @u
argue	A: g j u:
argues	A: g j u: z
arias	A: r\ i@ z
arietids	E r\ i t @ d z
ariosto's	e@ r\ i@ Q s t @u z
arista	@ r\ @ s t @
aristotelian	{ r\ @ s t Q t i: l i@ n
aristotle	{ r\ @ s t Q t @ l
arithmetic	@ r\ @ T m @ t i k
arithmetical	{ r\ @ T m E t i k @ l
arius	e@ r\ i@ s
arizona	{ r\ i z @u n @
arlington	A: l i N t @ n
arm	A: m
armed	A: m d
armenia	A: m i: n i @
armenia's	A: m i: n i @i z
armenian	A: m i n i@ n
armies	A: m i z
armored	A: m @ r\ d
armoured	A: m @ d
arms	A: m z
armstrong	A: m s t r\ Q N
army	A: m i
arnold	A: n @ l d
arnolfo	A: n Q l f @u
aromatic	{ r\ @ m { t i k
arrangements	@ r\ @i n d_0Z m @ n t s
array	@ r\ @i
arrived	@ r\ ai v d
arriving	@ r\ ai v i N
arrow	{ r\ @u
arrows	{ r\ @u z
art	A: t
arte	A: t
arte	A: t @i
artemia	A: t i: m i@
artery	A: t @ r\ i
arthur	A: T @ r\
article	A: t i k @ l
articles	A: t i k @ l z
artificial	A: t @ f i S @ l
artists	A: t @ s t s
arts	A: t s
as	{ z
asc	@i E s s i:
ascent	@ s E n t
aschaffenburg	@ s k A: f @ n b 3: g
ascii	{ s k i:
ascribed	@ s k r\ ai b d
asd	@i E s d i:
asean	{ s i@ n
asgardian	@ z g A: d i@ n
ashcroft	{ S k r\ Q f t
ashkenazi	{ S k n @i z i
ashton	{ S t @ n
asia	@i Z @
asian	@i Z @ n
asiatic	@i z i { t i k
aside	@ s ai d
asked	A: s k t
asparagales	@ s p { r\ @ g @i l z
aspect	{ s p E k t
aspects	{ s p E k t s
asphyxia	{ s f i k s i@
aspirin	{ s p r\ @ n
assassinated	@ s { s @ n @i t @ d
assassination	@ s { s @ n @i S @ n
assault	@ s O: l t
assembly	@ s E m b l i
asserted	@ s 3: t @ d
assessment	@ s E s m @ n t
assigned	@ s ai n d
assistance	@ s @ s t @ n s
assistant	@ s @ s t @ n t
assistants	@ s @ s t @ n t s
assisting	@ s i s t i N
assistive	@ s @ s t @ v
associated	@ s @u S i @i t @ d
association	@ s @u s i @i S @ n
associations	@ s @u s i @i S @ n z
assumed	@ s j u: m d
assyrian	@ s i r\ i@ n
astatic	@ s t { t i k
asterales	{ s t @ r\ A: l z
asterid	{ s t @ r\ @ d
asteroid	{ s t @ r\ Oi d
astor	@ s t @ r\
astounding	@ s t au n d i N
astro	{ s t r\ @u
astrologers	@ s t r\ Q l @ d_0Z @ z
astrological	{ s t r\ @ l Q d_0Z i k @ l
astrology	@ s t r\ Q l @ d_0Z i
astronomer	@ s t r\ Q n @ m @ r\
astronomers	@ s t r\ Q n @ m @ z
astronomical	{ s t r\ @ n Q m i k @ l
astronomy	@ s t r\ Q n @ m i
asuka	@ s u: k @
aswan	{ s w a n
asymptotic	@i s @ m t @ m { t i k
asynchronous	@i s @ N k r\ @ n @ s
at	{ t
atari	@ t A: r\ i
ate	E t
ath	@i t i: @i tS
athabasca	{ T @ b { s k @
atheism	@i T i @ z @ m
atheist	@i T i @ s t
atheists	@i T i @ s t s
athena	@ T i: n @
athenian	@ T i: n i@ n
athenians	@ T i: n i@ n z
athens	{ T @ n z
athlete	{ T l i: t
athletic	{ T l E t i k
atlanta	{ t l { n t @
atlantic	{ t l { n t i k
atlantis	{ t l { n t @ s
atmosphere	{ t m @ s f i@ r\
atmospheric	{ t m @ s f E r\ i k
atolls	{ t O: l z
atomic	@ t Q m i k
atomically	@ t Q m i k l i
atoms	{ t @ m z
atp	@i t i: p i:
atrocities	@ t r\ Q s @ t i z
attack	@ t { k
attacked	@ t { k t
attacks	@ t { k s
attaining	@ t @i n i N
attempt	@ t E m p t
attempted	@ t E m p t @ d
attempts	@ t E m p t s
attended	@ t E n d @ d
attending	@ t E n d i N
attention	@ t E n S @ n
atteridgeville	@ t r\ i d_0Z v @ l
attic	{ t i k
attitude	{ t @ t j u: d
attorney	@ t 3: n i
attract	@ t r\ { k t
attracting	@ t r\ { k t i N
attraction	@ t r\ { k S @ n
attractions	@ t r\ { k S @ n z
attribute	{ t r\ @ b j u: t
au	@u
auburn	O: b @ n
audi	au d i
audience	O: d i@ n s
audio	O: d i @u
auditory	O: d @ t r\ i
audrey	O: d r\ i
audubon	O: d @ b @ n
augmented	O: g m E n t @ d
august	O: g a s t
augusti	O: g a s t i
augustus	O: g a s t @ s
aurel	O: r\ @ l
auschwitz	au S v i t s
austerity	O: s t E r\ @ t i
austin	O: s t @ n
australia	O: s t r\ @i l i@
australian	O: s t r\ @i l i@ n
austria	O: s t r\ i@
austrian	O: s t r\ i@ n
auteur	O: t 3: r\
author	O: T @ r\
authorised	O: T @ r\ ai z d
authorities	O: T Q r\ @ t i z
authority	O: T Q r\ @ t i
authorlink	O: T @ l i N k
authors	O: T @ z
autism	O: t @ z @ m
auto	O: t @u
autobiographers	O: t @u b ai Q g r\ @ f @ z
autoimmune	O: t @u i m j u: n
automated	O: t @ m @i t @ d
automatic	O: t @ m { t i k
automation	O: t @ m @i S @ n
automotive	O: t @u m @u t @ v
autonomous	O: t Q n @ m @ s
autumn	O: t @ m
auxiliary	O: g z @ l i@ r\ i
av	@i v i:
available	@ v @i l @ b @ l
avenue	{ v @ n j u:
average	{ v @ r\ i d_0Z
averaged	{ v @ r\ i d_0Z d
aviation	@i v i @i S @ n
aviators	@i v i @i t @ z
avionics	@i v i Q n i k s
avoid	@ v Oi d
aw	@i d a b @ l j u:
awakening	@ w @i k @ n i N
award	@ w O: d
awarded	@ w O: d @ d
awards	@ w O: d z
awareness	@ w e@ n @ s
away	@ w @i
axe	{ k s
axiomatic	{ k s i@ m { t i k
axis	{ k s @ s
axonal	{ k s @ n @ l
azerbaijan	{ z @ b ai d_0Z { n
azusa	{ z z @
b	b i:
ba	b i: @i
babbage	b { b i d_0Z
babe	b @i b
background	b { k g r\ au n d
backs	b { k s
bacterial	b { k t i@ r\ i@ l
bad	b { d
badan	b { d @ n
bafta	b { f t @
baggage	b { g i d_0Z
bagpipe	b { g p ai p
bahia	b a h\ i@
bahrain	b a r\ @i n
bai	b i: @i ai
baker	b @i k @ r\
balance	b { l @ n s
balanchine	b { l @ n S i: n
balev	b @i l E v
ball	b O: l
balliol	b @i l i@ l
ballistic	b @ l @ s t i k
ballot	b { l @ t
ballston	b O: l s t @ n
baltic	b O: l t i k
baltimore	b O: l t @ m O: r\
ban	b { n
banach	b { n { k
band	b { n d
bandar	b { n d @ r\
bands	b { n d z
banff	b { n f
bang	b { N
bangladesh	b { N g l @ d E S
bank	b { N k
banking	b { N k i N
banknotes	b { N k n @u t s
bankrupt	b { N k r\ a p t
bankruptcy	b { N k r\ @ p s i
banks	b { N k s
bantu	b { n t u:
baptist	b { p t @ s t
baptists	b { p t @ s t s
bar	b A: r\
barack	b { r\ @ k
barak	b a r\ a k
barak	b { r\ @ k
barbara	b A: b r\ @
barbary	b A: b @ r\ i
barberton	b A: b 3: t @ n
barbra	b A: b r\ @
barcelona	b A: s @ l @u n @
bargaining	b A: g @ n i N
barge	b A: d_0Z
barkley	b A: k l i
barkly	b A: k l i
barney	b A: n i
baroness	b { r\ @ n E s
baronial	b @ r\ @u n i@ l
barons	b { r\ @ n z
baroque	b a r\ Q k
barrier	b { r\ i@ r\
barrow	b { r\ @u
barthelme's	b A: T E l m i: z
basal	b @i s @ l
base	b @i s
baseball	b @i s b O: l
based	b @i s t
baserunning	b @i s i@ r\ a n i N
bases	b @i s i: z
basic	b @i s i k
basically	b @i s i k l i
basilica	b @ s @ l i k @
basin	b @i s @ n
basins	b @i s @ n z
basis	b @i s @ s
basketball	b A: s k @ t b O: l
basque	b { s k
bass	b @i s
bass	b { s
bathroom	b A: T r\ u: m
battery	b { t @ r\ i
batting	b { t i N
battista	b { t @ s t @
battle	b { t @ l
battlecruiser	b { t @ l k r\ u: z @ r\
battlefront	b { t @ l f r\ a n t
bay	b @i
bayesian	b @i z i@ n
bayonets	b @i @ n E t s
bbc	b i: b i: s i:
bc	b i: s i:
bce	b i: s i: i:
be	b i:
beaches	b i: tS @ z
beadwork	b i: d w 3: k
bealtaine	b i: l t @i n
beam	b i: m
beams	b i: m z
beans	b i: n z
bear	b e@ r\
beard	b i@ d
beat	b i: t
beaufort	b @u f O: t
beautiful	b j u: t @ f @ l
beauty	b j u: t i
beaver	b i: v @ r\
beck	b E k
becomes	b i k a m z
beda	b i d @
bede's	b i d i: z
bedford	b E d f @ d
bee	b i
began	b i g { n
begawan	b i g { w @ n
begin	b i g i n
beginning	b i g i n i N
behaves	b i h\ @i v z
behavioral	b i h\ @i v i@ r\ @ l
bela	b E l a
belarusian	b E l a r\ u: s i@ n
belfast	b { l f A: s t
belfry	b { l f r\ i
belgians	b { l d_0Z @ n z
belgrade	b E l g r\ @i d
belief	b i l i: f
believe	b i l i: v
believed	b i l i: v d
bell	b E l
bellville	b E l v @ l
belt	b E l t
ben	b E n
benchmarks	b E n tS m A: k s
bend	b E n d
beneath	b i n i: T
benedict	b E n @ d i k t
benefits	b E n @ f @ t s
benevolent	b @ n E v @ l @ n t
benito	b E n i: t @u
benjamin	b E n d_0Z @ m @ n
bennet	b E n @ t
benoni	b E n @u n i
benson	b E n s @ n
benton	b E n t @ n
benzoic	b E n z Oi i k
berenguer	b i r\ E N g @ r\
bergamo	b 3: g A: m @u
berger	b 3: g @ r\
bergson	b 3: g s @ n
bering	b E r\ i N
berlin	b 3: l @ n
berlusconi	b E r\ l u: s k @u n i
bernard	b 3: n @ d
bernice	b 3: n @ s
berth	b 3: T
bertha	b 3: T @
besicovitch	b E s i k @u v i tS
best	b E s t
bestseller	b E s t s E l @ r\
bet	b E t
beta	b i: t @
bethal	b i: T @ l
bethlehem	b E T l i h\ E m
better	b E t @ r\
beverages	b E v @ r\ i d_0Z @ z
bharatiya	b { r\ @ t i: j @
bhutto	b u: t @u
bible	b ai b @ l
bibleverse	b ai b @ l v 3: s
biblical	b @ b l i k @ l
bicameral	b ai k { m @ r\ @ l
bicontinental	b ai k Q n t i n E n t @ l
bien	b ai n
big	b i g
biggest	b i g @ s t
bilateral	b ai l { t @ r\ @ l
bill	b @ l
billboard	b @ l b O: d
billion	b @ l i@ N
billy	b @ l i
bin	b @ n
binary	b ai n @ r\ i
binding	b ai n d i N
bingaman's	b i N g @ m A: n z
biodiversity	b ai @u d ai v 3: s @ t i
biographer	b ai Q g r\ @ f @ r\
biographies	b ai Q g r\ @ f i z
biological	b ai @ l Q d_0Z i k @ l
biologists	b ai Q l @ d_0Z @ s t s
biology	b ai Q l @ d_0Z i
biopsy	b ai Q p s i
bios	b ai Q s
biotechnology	b ai @u t E k n Q l @ d_0Z i
bipedal	b ai p E d @ l
bipolar	b ai p @u l @ r\
birds	b 3: d z
birth	b 3: T
bisexual	b ai s E k S u@ l
bishop	b i S @ p
bishops	b i S @ p s
bismarck	b @ z m A: k
bisulcus	b ai s a l k @ s
bit	b @ t
bitola	b @ t @ l @
bits	b @ t s
bjp	b i: d_0Z @i p i:
black	b l { k
blackadder	b l { k { d @ r\
blacksash	b l { k s { S
bladder	b l { d @ r\
blade	b l @i d
blair	b l e@ r\
blanking	b l { N k i N
bleeding	b l i: d i N
blending	b l E n d i N
blends	b l E n d z
blind	b l ai n d
bloc	b l Q k
block	b l Q k
blocks	b l Q k s
bloemfontein	b l U m f @ n t @i n
bloemfontein	b l U m f @ n t i: n
blog	b l Q g
blood	b l a d
bloodline	b l a d l ai n
bloomberg	b l u: m b 3: g
blows	b l @u z
blue	b l u:
blues	b l u: z
bluetooth	b l u: t u: T
bnp	b i: E n p i:
boad	b @u d
board	b O: d
boards	b O: d z
boas	b @u @ z
boasted	b @u s t @ d
boat	b @u t
bob	b Q b
bobby	b Q b i
bodies	b Q d i z
bodily	b Q d @ l i
body	b Q d i
bofh	b i: @u E f @i tS
bogus	b @u g @ s
boinae	b Oi n i
boksburg	b Q k s b 3: g
bold	b @u l d
boles	b @u l z
bolivia	b @ l @ v i@
bologna	b @ l Q n j @
bolshevik	b Q l S @ v i k
bomber	b Q m @ r\
bombing	b Q m i N
bombs	b Q m z
bonaparte	b @u n @ p A: t
bond	b Q n d
bond's	b Q n d z
bonding	b Q n d i N
bonds	b Q n d z
boni	b @u n i
boniface	b Q n @ f @i s
bony	b @u n i
book	b U k
booker	b U k @ r\
books	b U k s
boolean	b u: l i@ n
booming	b u: m i N
boosters	b u: s t @ z
booth	b u: D
border	b O: d @ r\
bordering	b O: d @ r\ i N
borders	b O: d @ z
bore	b O: r\
borges	b O: d_0Z @ z
boris	b Q r\ @ s
born	b O: n
borsuk	b O: s u: k
bose	b @u s
bosnia	b Q s n i@
bosnian	b Q s n i@ n
boston	b Q s t @ n
boswell	b Q z w E l
botanic	b @ t { n i k
both	b @u T
bothaville	b @u t a v @ l
bottle	b Q t @ l
boulder	b @u l d @ r\
boulders	b @u l d @ z
boulevard	b u: l @ v A: d
boundary	b au n d r\ i
boven	b a v @ n
bowed	b au d
bowel	b au @ l
bowl	b @u l
box	b Q k s
boy	b Oi
boyce	b Oi s
boyle	b Oi l
boys	b Oi z
bra	b r\ A:
brain	b r\ @i n
brakpan	b r\ a k p a n
brakpan	b r\ { k p { n
branch	b r\ A: n tS
branching	b r\ A: n tS i N
brand	b r\ { n d
brandenburg	b r\ { n d @ n b 3: g
brands	b r\ { n d z
brantford	b r\ { n t f @ d
braun	b r\ O: n
brave	b r\ @i v
bravery	b r\ @i v @ r\ i
braves	b r\ @i v z
brazilian	b r\ @ z @ l i@ n
bre	b i: A: r\ i:
bre	b r\ i:
breakbulk	b r\ @i k b a l k
breakfast	b r\ E k f @ s t
breaks	b r\ @i k s
breast	b r\ E s t
breaststroke	b r\ E s t s t r\ @u k
breathing	b r\ i: D i N
breed	b r\ i: d
breeders	b r\ i: d @ z
breeds	b r\ i: d z
brendan	b r\ E n d @ n
breton	b r\ E t @ n
brewis	b r\ u: @ s
breyten	b r\ @i t @ n
brian	b r\ ai @ n
brick	b r\ i k
bricket	b r\ i k @ t
bridge	b r\ i d_0Z
bridgepoint	b r\ i d_0Z p Oi n t
bridgeport	b r\ i d_0Z p O: t
bridget	b r\ i d_0Z @ t
briefly	b r\ i: f l i
brien	b r\ i@ n
brigade	b r\ i g @i d
brigadier	b r\ i g @ d i@ r\
brigham	b r\ i g @ m
bright	b r\ ai t
brine	b r\ ai n
brit	b r\ @ t
britain	b r\ @ t @ n
britain's	b r\ @ t @ n z
british	b r\ @ t i S
brixton	b r\ i k s t @ n
broad	b r\ O: d
broadband	b r\ O: d b { n d
broadcast	b r\ O: d k A: s t
broadcasting	b r\ O: d k A: s t i N
broadstone	b r\ O: d s t @u n
broadway	b r\ O: d w @i
brock	b r\ Q k
broke	b r\ @u k
brokered	b r\ @u k @ d
bromwich	b r\ @ m w i tS
broncos	b r\ Q N k @u z
bronx	b r\ Q N k s
bronze	b r\ Q n z
brood	b r\ u: d
brooklyn	b r\ U k l @ n
brother	b r\ a D @ r\
brotherhood	b r\ a D @ h\ U d
brothers	b r\ a D @ z
brought	b r\ O: t
brouwer	b r\ @u w @ r\
brown's	b r\ au n z
browne	b r\ au n
browns	b r\ au n z
broz	b r\ a T @ z
broz	b r\ Q z
bruce	b r\ u: s
brunel	b r\ u: n @ l
brunswick	b r\ a n z w i k
brute	b r\ u: t
brutus	b r\ u: t @ s
bryan	b r\ ai @ n
brythonic	b r\ i T Q n i k
buccaneers	b a k @ n i@ z
buchla	b U k l @
bucure	b @ k j u@ r\
buddha	b U d @
buddhism	b U d @ z @ m
buddhist	b U d @ s t
buddhists	b U d @ s t s
buddy	b a d i
budget	b a d_0Z @ t
buenos	b i U n @ s
buffer	b a f @ r\
bugersfort	b u: g @ s f O: t
building	b @ l d i N
buildings	b @ l d i N z
built	b @ l t
buke	b j u: k
bulat	b j U l { t
bulgarian	b a l g e@ r\ i@ n
bulletin	b U l @ t @ n
bun	b a n
burckhardt's	b 3: k h\ A: t s
burden	b 3: d @ n
bureau	b j u@ r\ @u
buren	b j u@ r\ @ n
burgess	b 3: d_0Z @ s
burghs	b 3: g z
burials	b E r\ i@ l z
burma's	b 3: m z
burmese	b 3: m i: z
burning	b 3: n i N
burnside	b 3: n s ai d
buryats	b E r\ i @i t s
bus	b a s
buses	b a s @ s
bush	b U S
bushbuckridge	b U S b a k r\ i d_0Z
business	b @ z n @ s
businesspeople	b @ z n @ s p i: p @ l
but	b a t
butler	b a t l @ r\
buy	b ai
buyer	b ai @ r\
by	b ai
bypass	b ai p A: s
byron	b i r\ @ n
bysshe	b ai s S
c	s i:
caballero	k { b @ l E r\ @u
caballus	k @ b a l @ s
cable	k @i b @ l
caesar	s i: z @ r\
caesarion	s i z E r\ i@ n
cafe	k { f @i
calcium	k { l s i@ m
calculating	k { l k j U l @i t i N
calculations	k { l k j U l @i S @ n z
calculators	k { l k j U l @i t @ z
calculus	k { l k j U l @ s
caledonian	k { l @ d @u n i@ n
calendar	k { l @ n d @ r\
california	k { l i f O: n i@
called	k O: l d
callertonville	k O: l @ t @ n v @ l
calls	k O: l z
calvin	k { l v @ n
cambrian	k { m b r\ i@ n
cambridge	k @i m b r\ i d_0Z
came	k @i m
camel	k { m @ l
cameras	k { m @ r\ @ z
camino	k { m i: n @u
camp	k { m p
campaign	k { m p @i n
camping	k { m p i N
camps	k { m p s
campus	k { m p @ s
camus	k { m i:
camus	k { m i: s
can	k { n
canada	k { n @ d @
canadian	k @ n @i d i@ n
canby	k { n b i
cancer	k { n s @ r\
candidate	k { n d i d @ t
candidates	k { n d i d @ t s
cane	k @i n
canners	k { n @ z
cannes	k { n
cannibalism	k { n @ b @ l @ z @ m
canon	k { n @ n
canonized	k { n @ n ai z d
cant	k { n t
canterbury	k { n t @ b r\ i
canyons	k { n j @ n z
canzibe	k { n z ai b
cap	k { p
capabilities	k @i p @ b @ l @ t i z
capability	k @i p @ b @ l @ t i
capable	k @i p @ b @ l
capacity	k @ p { s @ t i
cape	k @i p
capita	k { p @ t @
capital	k { p @ t @ l
capitalisation	k { p @ t @ l @ s @i S @ n
capitals	k { p @ t @ l z
capitol	k { p @ t @ l
capone	k @ p @u n
cappella	k { p E l @
caps	k { p s
capsule	k { p s j u: l
captain	k { p t @ n
captured	k { p tS @ d
car	k A: r\
caracal	k { r\ @ k @ l
caravan	k { r\ @ v { n
caravans	k { r\ @ v { n z
carbohydrate	k A: b @ h\ ai d r\ @i t
carbon	k A: b @ n
carbonate	k A: b @ n @ t
carbonates	k A: b @ n @i t s
carboxylic	k A: b Q k s @ l i k
carcinoma	k A: s @ n @u m @
card	k A: d
cardassian	k A: d { s i@ n
cardiac	k A: d i { k
cardiff	k A: d @ f
cardinals	k A: d @ n @ l z
cardiovascular	k A: d i @u v { s k j U l @ r\
cards	k A: d z
care	k e@ r\
career	k @ r\ i@ r\
caretaker	k e@ t @i k @ r\
caribbean	k @ r\ @ b i: @ n
caricom	k { r\ i k Q m
carl	k A: l
carla	k A: l @
carletonville	k A: l t @ n v @ l
carlos	k A: l @ s
carnegie	k A: r\ n i: g i
carnivores	k A: n i v O: z
carol's	k { r\ @ l z
carolina	k { r\ @ l ai n @
caroline	k { r\ @ l @ n
carolingian	k { r\ @ l i n d_0Z i@ n
carpal	k A: p @ l
carrier	k { r\ i@ r\
carriers	k { r\ i@ z
carries	k { r\ i z
carroll	k { r\ @u l
carson	k A: s @ n
carte	k A: t
cartel	k A: t E l
carter	k A: t @ r\
carthage	k A: T i d_0Z
cartographers	k A: t Q g r\ @ f @ z
cartoon	k A: t u: n
cartoonists	k A: t u: n @ s t s
cartoons	k A: t u: n z
cartridges	k A: t r\ i d_0Z @ z
carver	k A: v @ r\
case	k @i s
cases	k @i s @ s
cash	k { S
casimir	k { s i m i@ r\
casino	k @ s i: n @u
caspar	k { s p @ r\
cast	k A: s t
castel	k A: s @ l
castle	k A: s @ l
castlereagh's	k A: s @ l r\ @i z
casual	k { Z u@ l
casually	k { Z u@ l i
casualties	k { Z u@ l t i z
catalan	k { t @ l { n
catalogs	k { t @ l Q g z
catastrophic	k { t @ s t r\ Q f i k
category	k { t @ g @ r\ i
cathedral	k @ T i: d r\ @ l
catherina	k { T @ r\ i: n @
catherine	k { T r\ @ n
cathode	k { T @u d
catholic	k { T l i k
catholicism	k @ T Q l @ s @ z @ m
catholics	k { T l i k s
cathrina	k @ t r\ i: n @
cauchy	k @u S i
cause	k O: z
caused	k O: z d
causing	k O: z i N
cavaliers	k { v @ l i@ z
cavalry	k { v @ l r\ i
cave	k @i v
cavefish	k { v f i S
cavell	k { v E l
caves	k @i v z
cbs	s i: b i: E s
cdu	s i: d i: j u:
cease	s i: s
ceased	s i: s t
ceberano	s E b @ r\ A: n @u
cebu	s E b u:
ceded	s i: d @ d
celestial	s @ l E s t i@ l
celestino	s @ l E s t i: n @u
cell	s E l
celled	s E l d
cells	s E l z
cellular	s E l j U l @ r\
celtic	k E l t i k
cemetery	s E m @ t r\ i
censorship	s E n s @ S @ p
census	s E n s @ s
censuses	s E n s @ s @ s
centauri	s E n t O: r\ i
centenarians	s E n t @ n e@ r\ i@ n z
center	s E n t @ r\
centered	s E n t @ d
centers	s E n t @ z
central	s E n t r\ @ l
centralised	s E n t r\ @ l @ s t
centrally	s E n t r\ @ l i
centre	s E n t @ r\
centres	s E n t @ z
centronics	s E n t r\ Q n i k s
centuries	s E n tS @ r\ i z
centurion	s E n tS u@ r\ i@ n
century	s E n tS @ r\ i
centuryodowska	s E n tS @ r\ i @u d @u s k @
ceremonies	s E r\ @ m @ n i z
ceremony	s E r\ @ m @ n i
certain	s 3: t @ n
certification	s 3: t @ f i k @i S @ n
certified	s 3: t @ f ai d
cfa	s i: E f @i
cfb	s i: E f b i:
cgi	s i: d_0Z i: ai
ch	s i: @i tS
chad	tS { d
chagrin	S { g r\ @ n
chain	tS @i n
chains	tS @i n z
chalcidice	tS { l s i d @ s
challenge	tS { l @ n d_0Z
challenger	tS { l @ n d_0Z @ r\
chamber	tS @i m b @ r\
chamberlain	tS @i m b @ l @ n
chambers's	tS @i m b @ s z
chambersburg	tS @i m b @ s b 3: g
champion	tS { m p i@ n
championed	tS { m p i@ n d
champions	tS { m p i@ n z
championship	tS { m p i@ n S @ p
championships	tS { m p i@ n S @ p s
chancellor	tS A: n s @ l @ r\
chancellors	tS A: n s @ l @ z
chancellorsville	tS A: n s @ l @ s v @ l
change	tS @i n d_0Z
changed	tS @i n d_0Z d
changes	tS @i n d_0Z @ z
changing	tS @i n d_0Z i N
channel	tS { n @ l
channeled	tS { n @ l d
chaplin	tS { p l @ n
chapman	tS { p m @ n
character	k { r\ @ k t @ r\
characteristic	k { r\ @ k t @ r\ @ s t i k
characters	k { r\ @ k t @ z
charge	tS A: d_0Z
charged	tS A: d_0Z d
chargers	tS A: d_0Z @ z
charles	tS A: l z
charlie	tS A: l i
charlotte	S A: l @ t
chart	tS A: t
charter	tS A: t @ r\
chartered	tS A: t @ d
charters	tS A: t @ z
chat	tS { t
cheap	tS i: p
cheaper	tS i: p @ r\
cheerleading	tS i@ l i: d i N
chekhov	tS E k Q f
chemical	k E m i k @ l
chemicals	k E m i k @ l z
chemistry	k E m @ s t r\ i
chemists	k E m @ s t s
cheney	tS @i n i
chengdu	tS E n d u:
chess	tS E s
chi	k ai
chicago	S i k A: g @u
chicken	tS i k @ n
chief	tS i: f
chiefs	tS i: f s
child	tS ai l d
childhood	tS ai l d h\ U d
children	tS @ l d r\ @ n
children's	tS @ l d r\ @ n z
chile	tS i l @i
chile	tS @ l i
chili	tS @ l i
chilli	tS @ l i
chimpanzees	tS @ m p { n z i: z
china	tS ai n @
chinese	tS ai n i: z
ching	t S i N
chipmunks	tS @ p m a N k s
chirac	S i r\ a k
choice	tS Oi s
choking	tS @u k i N
cholerae	k Q l @ r\ i
chomsky	tS @ m s k i
chris	k r\ @ s
christ	k r\ ai s t
christi	k r\ i s t i
christian	k r\ @ s tS @ n
christiana	k r\ @ s t i A: n a
christianity	k r\ @ s t i { n @ t i
christians	k r\ @ s tS @ n z
christine	k r\ i s t i: n
christmas	k r\ @ s m @ s
chromatic	k r\ @u m { t i k
chromatids	k r\ @u m a t @ d z
chromatin	k r\ @u m @i t @ n
chromodynamics	k r\ @u m @u d ai n { m i k s
chromosomal	k r\ @u m @ s @u m @ l
chronic	k r\ Q n i k
chronicles	k r\ Q n i k @ l z
chrysostom	k r\ @ s Q s t @ m
chubby	tS a b i
chukotka	tS U k Q t
church	tS 3: tS
churches	tS 3: tS @ z
churchill	tS 3: tS h\ @ l
cia	s i: ai @i
cider	s ai d @ r\
cilia	s @ l i@
cincinnati	s @ n s @ n { t i
cinema	s @ n @ m @
cinematographers	s @ n @ m @ t Q g r\ @ f @ z
cinematography	s @ n @ m @ t Q g r\ @ f i
cipher	s ai f @ r\
circle	s 3: k @ l
circuit	s 3: k @ t
circuits	s 3: k @ t s
circular	s 3: k j U l @ r\
circularly	s 3: k j U l @ l i
circumpolar	s 3: k @ m p @u l @ r\
cis	s i: ai E s
citation	s ai t @i S @ n
cite	s ai t
cities	s @ t i z
citizens	s @ t @ z @ n z
citizenship	s @ t @ z @ n S @ p
citric	s i t r\ i k
citrullinated	s @ t r\ @ l i n @i t @ d
city	s @ t i
city's	s @ t i z
ciudad	s i@ d { d
civil	s @ v @ l
civilian	s @ v @ l i@ n
civilis	s @ v @ l @ s
civilisation	s @ v @ l @ s @i S @ n
civilization	s @ v @ l ai z @i S @ n
civilizations	s @ v @ l ai z @i S @ n z
clade	k l @i d
claim	k l @i m
claimed	k l @i m d
claims	k l @i m z
clan	k l { n
clandestine	k l { n d @ s t i: n
clara	k l A: r\ a
clara	k l E r\ @
clarence	k l { r\ @ n s
clarence's	k l { r\ @ n s @ s
clarify	k l { r\ @ f ai
clarifyme	k l { r\ @ f ai m
clarinetist	k l { r\ @ n E t @ s t
clark	k l A: k
clarksburry	k l A: k s b @ r\ i
class	k l A: s
classic	k l { s i k
classical	k l { s i k @ l
classics	k l { s i k s
classification	k l { s i f i k @i S @ n
claudia	k l O: d i@
claudius	k l O: d i@ s
clausewitz	k l O: z w @ t s
clay	k l @i
clean	k l i: n
cleaner	k l i: n @ r\
clear	k l i@ r\
clearing	k l i@ r\ i N
clearly	k l i@ l i
clement	k l E m @ n t
clergy	k l 3: d_0Z i
clerk	k l A: k
cleveland	k l i: v l @ n d
client	k l ai @ n t
clients	k l ai @ n t s
climate	k l ai m @ t
climax	k l ai m { k s
climbers	k l ai m @ z
clinic	k l @ n i k
clinical	k l @ n i k @ l
clinton	k l @ n t @ n
clippers	k l @ p @ z
clips	k l @ p s
clive	k l ai v
cloan	k l @u n
clock	k l Q k
clocolan	k l Q k @ l @ n
close	k l @u s
closed	k l @u z d
closely	k l @u s l i
closest	k l @u s @ s t
cloud	k l au d
clouds	k l au d z
club	k l a b
clubs	k l a b z
coach	k @u tS
coachella	k @u tS E l a
coarsely	k O: s l i
coast	k @u s t
coastal	k @u s t @ l
coasts	k @u s t s
coat	k @u t
coauthors	k @u T @ z
cocos	k @u k @u z
code	k @u d
coded	k @u d @ d
codes	k @u d z
coding	k @u d i N
cody	k @ d i
coen	k i: n
coffee	k Q f i
cognates	k Q g n @i t s
cognitive	k Q g n @ t @ v
cohen	k @u h\ @ n
coins	k Oi n z
cold	k @u l d
coleridge	k @u l r\ i d_0Z
coles	k @u l z
colesberg	k @u l z b 3: g
colin	k Q l @ n
colins	k Q l @ n z
coliseum	k Q l @ s i@ m
collage	k Q l A: Z
collapse	k @ l { p s
collapsed	k @ l { p s t
collasuyu	k Q l @ s U j u:
colleague	k Q l i: g
collectible	k @ l E k t @ b @ l
collection	k @ l E k S @ n
collections	k @ l E k S @ n z
collective	k @ l E k t @ v
collectivized	k @ l E k t @ v ai z d
college	k Q l i d_0Z
colleges	k Q l i d_0Z @ z
collegiate	k @ l i: d_0Z i@ t
collet	k @ l @ t
collider	k @ l ai d @ r\
collins	k Q l @ n z
cologne	k @ l @u n
colombian	k @ l Q m b i@ n
colonial	k @ l @u n i@ l
colonies	k Q l @ n i z
colonisation	k Q l @ n @ s @i S @ n
colonization	k Q l @ n ai z @i S @ n
colony	k Q l @ n i
color	k a l @ r\
colorado	k Q l @ r\ A: d @u
colours	k a l @ z
colt	k @u l t
columbia	k @ l a m b i@
columbine	k Q l @ m b ai n
columnist	k Q l @ m n @ s t
com	k Q m
comando	k @ m A: n d @u
combat	k Q m b { t
combinatorial	k Q m b @ n @ t O: r\ i@ l
combined	k @ m b ai n d
combining	k @ m b ai n i N
combustion	k @ m b a s tS @ n
come	k a m
comedy	k Q m @ d i
comes	k a m z
comic	k Q m i k
comical	k Q m i k @ l
comics	k Q m i k s
coming	k a m i N
comm	k Q m
comm	s i: @u E m E m
comma	k Q m @
command	k @ m A: n d
commander	k @ m A: n d @ r\
commandos	k @ m A: n d @u z
commedia	k @ m i: d i@
commemorating	k @ m E m @ r\ @i t i N
commemorative	k @ m E m @ r\ @ t @ v
commentators	k Q m @ n t @i t @ z
commercial	k @ m 3: S @ l
commercially	k @ m 3: S l i
commission	k @ m i S @ n
commissioned	k @ m i S @ n d
commissioner	k @ m i S @ n @ r\
commitments	k @ m @ t m @ n t s
committed	k @ m @ t @ d
committee	k @ m @ t i
committees	k @ m @ t @ z
commodore	k Q m @ d O: r\
common	k Q m @ n
commonly	k Q m @ n l i
commonwealth	k Q m @ n w E l T
communication	k @ m j u: n i k @i S @ n
communications	k @ m j u: n i k @i S @ n z
communion	k @ m j u: n i@ n
communion's	k @ m j u: n i@ n z
communism	k Q m j U n @ z @ m
communist	k Q m j U n @ s t
communists	k Q m j U n @ s t s
communities	k @ m j u: n @ t i z
community	k @ m j u: n @ t i
commutative	k @ m j u: t @ t @ v
commuter	k @ m j u: t @ r\
comnenus	k Q m n E n @ s
comoros	k @ m O: z
compact	k Q m p { k t
companies	k a m p @ n i z
companion	k @ m p { n i@ n
company	k a m p @ n i
compared	k @ m p e@ d
comparisons	k @ m p { r\ @ s @ n z
compartment	k @ m p A: t m @ n t
compatible	k @ m p { t @ b @ l
compatibles	k @ m p { t @ b @ l z
compensation	k Q m p E n s @i S @ n
competition	k Q m p @ t i S @ n
competitions	k Q m p @ t i S @ n z
competitive	k @ m p E t @ t @ v
competitor	k @ m p E t @ t @ r\
competitors	k @ m p E t @ t @ z
compilation	k Q m p @ l @i S @ n
compiler	k @ m p ai l @ r\
compilers	k @ m p ai l @ z
complained	k @ m p l @i n d
complaining	k @ m p l @i n i N
complaints	k @ m p l @i n t s
complementarity	k Q m p l i m E n t { r\ @ t i
complete	k @ m p l i: t
completed	k @ m p l i: t @ d
completely	k @ m p l i: t l i
complex	k Q m p l E k s
complexes	k Q m p l E k s @ s
complexity	k @ m p l E k s @ t i
compliant	k @ m p l ai @ n t
complicated	k Q m p l i k @i t @ d
complications	k Q m p l i k @i S @ n z
component	k @ m p @u n @ n t
components	k @ m p @u n @ n t s
composed	k @ m p @u z d
composer	k @ m p @u z @ r\
composers	k @ m p @u z @ z
composing	k @ m p @u z i N
compositions	k Q m p @ z i S @ n z
compost	k Q m p Q s t
compound	k Q m p au n d
compounds	k Q m p au n d z
comprehensive	k Q m p r\ i h\ E n s @ v
compressed	k @ m p r\ E s t
compression	k @ m p r\ E S @ n
comprised	k @ m p r\ ai z d
compulsive	k @ m p a l s @ v
compulsory	k @ m p a l s @ r\ i
computational	k Q m p j U t @i S @ n @ l
computed	k @ m p j u: t @ d
computer	k @ m p j u: t @ r\
computers	k @ m p j u: t @ z
computing	k @ m p j u: t i N
conan	k @u n a n
concentrated	k Q n s @ n t r\ @i t @ d
concentration	k Q n s @ n t r\ @i S @ n
concentrations	k Q n s @ n t r\ @i S @ n z
concepts	k Q n s E p t s
concern	k @ n s 3: n
concerning	k @ n s 3: n i N
concerns	k @ n s 3: n z
concluded	k @ n k l u: d @ d
concord	k Q N k O: d
condemned	k @ n d E m d
condemning	k @ n d E m i N
condensate	k Q n d E n s @i t
condensates	k Q n d E n s @i t s
condensation	k Q n d E n s @i S @ n
condensed	k @ n d E n s t
condita	k @ n d @ t @
condition	k @ n d i S @ n
conditioning	k @ n d i S @ n i N
conditions	k @ n d i S @ n z
condoleezza	k Q n d @ l i: z @
conducted	k @ n d a k t @ d
conducting	k @ n d a k t i N
conductivity	k Q n d a k t @ v @ t i
conductor	k @ n d a k t @ r\
conductors	k @ n d a k t @ z
confederacy	k @ n f E d @ r\ @ s i
confederate	k @ n f E d @ r\ @ t
confederation	k @ n f E d @ r\ @i S @ n
confederations	k @ n f E d @ r\ @i S @ n z
confer	k @ n f 3: r\
conference	k Q n f @ r\ @ n s
configuration	k @ n f i g @ r\ @i S @ n
confirm	k @ n f 3: m
confiscated	k Q n f i s k @i t @ d
conflicts	k Q n f l i k t s
congestive	k @ n d_0Z E s t @ v
congleton	k Q N g @ l t @ n
congo	k Q N g @u
congreso	k Q N g r\ E s @u
congress	k Q N g r\ E s
congressional	k Q N g r\ E S @ n @ l
conic	k Q n i k
connected	k @ n E k t @ d
connecticut	k @ n E t i k @ t
connell	k @ n E l
connery	k Q n @ r\ i
connie	k Q n i
conquests	k Q N k w E s t s
consciousness	k Q n S @ s n @ s
consecutive	k @ n s E k j U t @ v
consensus	k @ n s E n s @ s
consequent	k Q n s @ k w @ n t
conservation	k Q n s @ v @i S @ n
conservative	k @ n s 3: v @ t @ v
consider	k @ n s @ d @ r\
considerable	k @ n s @ d @ r\ @ b @ l
considered	k @ n s @ d @ d
consist	k @ n s @ s t
consistent	k @ n s @ s t @ n t
consistently	k @ n s @ s t @ n t l i
consisting	k @ n s i s t i N
consists	k @ n s @ s t s
console	k Q n s @u l
consoles	k Q n s @u l z
consonant	k Q n s @ n @ n t
consort	k Q n s O: t
consortium	k @ n s O: t i@ m
constabulary	k @ n s t { b j U l @ r\ i
constantine	k Q n s t @ n t i: n
constantinople	k Q n s t @ n t i n @u p @ l
constants	k Q n s t @ n t s
constellation	k Q n s t @ l @i S @ n
constellations	k Q n s t @ l @i S @ n z
constituency	k @ n s t i t j u@ n s i
constituent	k @ n s t i t j u@ n t
constitution	k Q n s t i t j u: S @ n
constitutional	k Q n s t i t j u: S @ n @ l
constitutions	k Q n s t i t j u: S @ n z
constraint	k @ n s t r\ @i n t
construct	k @ n s t r\ a k t
constructed	k @ n s t r\ a k t @ d
construction	k @ n s t r\ a k S @ n
constructs	k @ n s t r\ a k t s
consuls	k Q n s @ l s
consumer	k @ n s j u: m @ r\
consumption	k @ n s a m p S @ n
contact	k Q n t { k t
contain	k @ n t @i n
container	k @ n t @i n @ r\
containing	k @ n t @i n i N
contains	k @ n t @i n z
contamination	k @ n t { m @ n @i S @ n
conteh	k Q n t @i
contemporaneous	k @ n t E m p @ r\ @i n i@ s
contemporary	k @ n t E m p r\ @ r\ i
content	k Q n t E n t
contest	k Q n t E s t
contestants	k @ n t E s t @ n t s
contests	k Q n t E s t s
contiguous	k @ n t i g j u@ s
continent	k Q n t @ n @ n t
continental	k Q n t i n E n t @ l
contingent	k @ n t i n d_0Z @ n t
continually	k @ n t @ n j u@ l i
continued	k @ n t @ n j u: d
continues	k @ n t @ n j u: z
continuing	k @ n t @ n j u: i N
continuous	k @ n t @ n j u@ s
continuum	k @ n t @ n j j u@ m
contra	k Q n t r\ @
contraceptive	k Q n t r\ @ s E p t @ v
contract	k Q n t r\ { k t
contractor	k Q n t r\ { k t @ r\
contradicting	k Q n t r\ @ d i k t i N
contributed	k @ n t r\ i b j u: t @ d
contributor	k @ n t r\ i b j u: t @ r\
control	k @ n t r\ @u l
controlled	k @ n t r\ @u l d
controllers	k @ n t r\ @u l @ z
controversial	k Q n t r\ @ v 3: S @ l
controversies	k Q n t r\ @ v 3: s i s
controversy	k Q n t r\ @ v 3: s i
convened	k @ n v i: n d
convention	k @ n v E n S @ n
conventional	k @ n v E n S @ n @ l
conventions	k @ n v E n S @ n z
convert	k Q n v 3: t
converts	k Q n v 3: t s
convicted	k @ n v i k t @ d
convolution	k Q n v @ l u: S @ n
convolutional	k Q n v @ l u: S @ n @ l
cook	k U k
cooley	k u: l i
coolidge	k u: l i d_0Z
cooper's	k u: p @ r\ z
cooperation	k @u Q p @ r\ @i S @ n
cooperative	k @u Q p @ r\ @ t @ v
coordinate	k @u O: d @ n @ t
coordinated	k @u O: d @ n @i t @ d
coordinates	k @u O: d @ n @ t s
copies	k Q p i z
copley	k Q p l i
coppola	k Q p @ l @
copronymus	k @u p r\ Q n @ m @ s
coptic	k Q p t i k
cordavox	k O: d @ v Q k s
cordell	k O: d E l
core	k O: r\
corinthian	k @ r\ @ n T i@ n
cornelius	k Q r\ n i: l i @ s
cornell	k O: n E l
coronal	k Q r\ @ n @ l
coronary	k Q r\ @ n @ r\ i
corporation	k O: p @ r\ @i S @ n
corps	k O: r\
corpse	k O: p s
corpus	k O: p @ s
correction	k @ r\ E k S @ n
correctional	k @ r\ E k S @ n @ l
correlated	k Q r\ @ l @i t @ d
correspondences	k Q r\ i s p Q n d @ n s @ s
corresponding	k Q r\ i s p Q n d i N
correspondingly	k Q r\ i s p Q n d i N l i
corridor	k Q r\ i d O: r\
corruption	k @ r\ a p S @ n
cortexes	k O: t E k s @ s
cortlandt	k O: t l { n
cos	k @ z
cosine	k @u s ai n
cosmic	k Q z m i k
cosmology	k Q z m Q l @ d_0Z i
cossack	k Q s { k
cost	k Q s t
costume	k Q s t j u: m
council	k au n s @ l
councillors	k au n s @ l @ z
countable	k au n t @ b @ l
counter	k au n t @ r\
countesses	k au n t { s @ s
countries	k a n t r\ i z
country	k a n t r\ i
country's	k a n t r\ i z
county	k au n t i
coup	k u:
coupled	k a p @ l d
couples	k a p @ l z
course	k O: s
court	k O: t
court's	k O: t s
courtiers	k O: t i@ z
courts	k O: t s
couscous	k U s k U s
cousin	k a z @ n
cousteau	k U s t @u
covariant	k @u v e@ r\ i@ n t
coven	k a v @ n
covenanter	k a v @ n @ n t @ r\
coventry	k a v @ n t r\ i
cover	k a v @ r\
covering	k a v @ r\ i N
covers	k a v @ z
coveted	k a v @ t @ d
cowbridge	k au b r\ i d_0Z
cp	s i: p i:
cpsu	s i: p i: E s j u:
cpu	s i: p i: j u:
craddock	k r\ { d @ k
crafts	k r\ A: f t s
cranberry	k r\ { n b @ r\ i
crash	k r\ { S
cream	k r\ i: m
create	k r\ i: @i t
created	k r\ i: @i t @ d
creation	k r\ i: @i S @ n
creationism	k r\ i: @i S @ n @ z @ m
creative	k r\ i: @i t @ v
creator	k r\ i: @i t @ r\
creatures	k r\ i: tS @ z
credibility	k r\ E d @ b @ l @ t i
credit	k r\ E d @ t
credited	k r\ E d @ t @ d
credito	k r\ E d @ t @u
creed	k r\ i: d
creek	k r\ i: k
crematorium	k r\ E m @ t O: r\ i@ m
crescent	k r\ E s @ n t
cretaceous	k r\ @ t @i S i@ s
crew's	k r\ u: z
cricket	k r\ i k @ t
cricketers	k r\ i k @ t @ z
crime	k r\ ai m
crimean	k r\ ai m i@ n
crimes	k r\ ai m z
criminal	k r\ @ m @ n @ l
crimson	k r\ @ m z @ n
crisis	k r\ ai s @ s
critic	k r\ @ t i k
critical	k r\ @ t i k @ l
criticism	k r\ @ t @ s @ z @ m
critics	k r\ @ t i k s
croatian	k r\ @u @i S @ n
crocker	k r\ Q k @ r\
crops	k r\ Q p s
cross	k r\ Q s
crow	k r\ @u
crowley	k r\ au l i
crown	k r\ au n
crown's	k r\ au n z
crowned	k r\ au n d
croydon	k r\ Oi d @ n
crusade	k r\ U s @i d
cryptographers	k r\ @ p t Q g r\ @ f @ z
cryptographic	k r\ @ p t @ g r\ { f i k
cryptography	k r\ @ p t Q g r\ @ f i
crystal	k r\ @ s t @ l
crystalline	k r\ @ s t @ l ai n
csa	s i: E s @i
csm	s i: E s E m
ct	s i: t i:
cuban	k j u: b @ n
cube	k j u: b
cubic	k j u: b i k
cue	k j u:
cuegloss	k j u: g l Q s
cuisine	k w i z i: n
cullinan	k a l @ n @ n
cult	k a l t
cultural	k a l tS @ r\ @ l
culture	k a l tS @ r\
cultures	k a l tS @ z
cumberland	k a m b @ l @ n d
cumulative	k j u: m j U l @ t @ v
cunha	k j U n h\ @
cup	k a p
cupertino	k U p @ t i: n @u
cure	k j u@ r\
curie	k j U r\ i
currency	k a r\ @ n s i
current	k a r\ @ n t
currently	k a r\ @ n t l i
currents	k a r\ @ n t s
cursive	k 3: s @ v
curt	k 3: t
curtis	k 3: t @ s
curtiss	k 3: t @ s
curve	k 3: v
customary	k a s t @ m @ r\ i
customer	k a s t @ m @ r\
customs	k a s t @ m z
cuts	k a t s
cutting	k a t i N
cy	s i: w ai
cyberwar	s ai b @ w O: r\
cycle	s ai k @ l
cyclones	s ai k l @u n z
cylinder	s @ l @ n d @ r\
cymbal	s @ m b @ l
cypriot	s @ p r\ i@ t
cytochrome	s ai t @ k r\ @u m
d	d i:
da	d a
da	d i: @i
dachau	d a tS au
daily	d @i l i
dakota's	d @ k @u t @ z
dall	d A: l
dallas	d { l @ s
dam	d { m
damage	d { m i d_0Z
dance	d A: n s
dancing	d A: n s i N
dandy	d { n d i
dangers	d @i n d_0Z @ z
daniel	d { n i@ l
danielsson	d { n i@ l s @ n
danish	d @i n i S
danny	d { n i
dansk	d a n s k
danville	d { n v @ l
daoud	d au d
dark	d A: k
data	d @i t @
database	d @i t @ b @i s
databases	d @i t @ b @i s i: s
databases	d @i t @ b @i s @ s
datagram	d @i t @ g r\ { m
date	d @i t
dated	d @i t @ d
dater	d @i t @ r\
dates	d @i t s
dating	d @i t i N
dative	d @i t @ v
daughters	d O: t @ z
daveyton	d @i v i t @ n
david	d @i v @ d
david's	d @i v i d z
davies	d @i v i z
davis	d @i v @ s
davy	d @i v i
dawn	d O: n
day	d @i
daylight	d @i l ai t
days	d @i z
daytime	d @i t ai m
dead	d E d
dealing	d i: l i N
deals	d i: l z
death	d E T
deaths	d E T s
debayle	d i b @i l
debbie	d E b i
debian	d i b i@ n
debit	d E b @ t
debugger	d i: b a g @ r\
debut	d @i b j u:
debuts	d @i b j u: z
dec's	d E k s
dec's	d i s E m b @ z
decapitated	d i k { p @ t @i t @ d
decay	d i k @i
december	d i s E m b @ r\
decena	d i: s i: n @
deception	d i s E p S @ n
decimal	d E s @ m @ l
decision	d i s i Z n
decisions	d i s i Z n z
deck	d E k
declaration	d E k l @ r\ @i S @ n
declared	d i k l e@ d
declension	d @ k l E n S @ n
declined	d i k l ai n d
declining	d i k l ai n i N
deco	d i: k @u
decoded	d i: k @u d @ d
decoherence	d i: k @u h\ i@ r\ @ n s
decorations	d E k @ r\ @i S @ n z
decreases	d i: k r\ i: s @ s
dedicated	d E d i k @i t @ d
dee	d i
deep	d i: p
deer	d i@ r\
deeside	d i: z ai d
defeated	d i f i: t @ d
defence	d i f E n s
defendant	d i f E n d @ n t
defender	d i f E n d @ r\
defenders	d i f E n d @ z
defending	d i f E n d i N
defense	d @ f E n s
deficiency	d i f i S @ n s i
deficit	d E f @ s @ t
deficits	d E f @ s @ t s
define	d i f ai n
defined	d i f ai n d
defines	d i f ai n z
definition	d E f i n i S @ n
definitions	d E f i n i S @ n z
defunct	d i f a N k t
degas	d i: g A:
degas	d i g { s
degeneracy	d i d_0Z E n @ r\ @ s i
degli	d E g l i
deified	d @i @ f ai d
deists	d i @ s t s
deities	d @i @ t i z
deities	d i @ t i z
del	d E l
delano	d i l A: n @u
delareyville	d @ l @ r\ @i v @ l
deliberately	d @ l @ b @ r\ @ t l i
dell	d E l
della	d E l @
delta	d E l t @
demanded	d i m A: n d @ d
demands	d i m A: n d z
demigods	d E m i g Q d z
demilitarized	d i: m @ l @ t @ r\ ai z d
demille	d @ m i l
democracies	d i m Q k r\ @ s i s
democracy	d i m Q k r\ @ s i
democrat	d E m @ k r\ { t
democratic	d E m @ k r\ { t i k
democratically	d E m @ k r\ { t i k l i
democrats	d E m @ k r\ { t s
demografisk	d E m @ g r\ { f @ s k
demographic	d E m @ g r\ { f i k
demographics	d E m @ g r\ { f i k z
demonstrated	d E m @ n s t r\ @i t @ d
den	d E n
deng	d E N
denied	d i n ai d
denillton	d E n @ l t @ n
denmark	d E n m A: k
dennilton	d E n @ l t @ n
dennis	d E n @ s
denomination	d i n Q m @ n @i S @ n
denominational	d i n Q m @ n @i S @ n @ l
denounce	d i n au n s
dense	d E n s
densely	d E n s l i
density	d E n s @ t i
deoxyribonucleic	d i Q k s ai r\ i b @ n j u: k l @i i k
department	d i p A: t m @ n t
departsworldwide	d i p A: t s w 3: l d w ai d
depend	d i p E n d
dependence	d i p E n d @ n s
dependency	d i p E n d @ n s i
dependent	d i p E n d @ n t
depending	d i p E n d i N
depicting	d i p i k t i N
deposition	d E p @ z i S @ n
deposits	d i p Q z @ t s
depressed	d i p r\ E s t
depressive	d i p r\ E s @ v
depth	d E p T
depute	d @ p j u: t
deputy	d E p j U t i
der	d i r\
derby	d A: b i
derivation	d E r\ @ v @i S @ n
derivatives	d @ r\ @ v @ t @ v z
derived	d i r\ ai v d
dervish	d 3: v i S
des	d E z
descended	d i s E n d @ d
descent	d i s E n t
describes	d @ s k r\ ai b z
description	d @ s k r\ @ p S @ n
descriptions	d @ s k r\ @ p S @ n z
descriptive	d @ s k r\ @ p t @ v
desert	d E z @ t
design	d i z ai n
designated	d E z i g n @i t @ d
designed	d i z ai n d
designer	d i z ai n @ r\
designers	d i z ai n @ z
designs	d i z ai n z
desire	d i z ai @ r\
desiring	d i z ai @ r\ i N
desk	d E s k
despite	d i s p ai t
destination	d E s t @ n @i S @ n
destinations	d E s t @ n @i S @ n z
destroyers	d @ s t r\ Oi @ z
destruction	d @ s t r\ a k S @ n
detail	d i: t @i l
detailed	d i: t @i l d
details	d i: t @i l z
detainees	d i: t @i n i: z
detecting	d i t E k t i N
detection	d i t E k S @ n
determinants	d i t 3: m @ n @ n t s
determine	d i t 3: m @ n
deterministic	d i t 3: m @ n i s t i k
detroit	d i t r\ Oi t
deus	d s
deuterium	d u: t i@ r\ i@ m
deuteronomy	d u: t @ r\ Q n @ m i
deutsche	d Oi tS @
dev	d E v
devanagari	d E v @ n A: g @ r\ i
develop	d i v E l @ p
developed	d i v E l @ p t
developer	d i v E l @ p @ r\
developers	d i v E l @ p @ z
developing	d i v E l @ p i N
development	d i v E l @ p m @ n t
developmental	d i v E l @ p m E n t @ l
developments	d i v E l @ p m @ n t s
deviation	d i: v i @i S @ n
device	d i v ai s
devices	d i v ai s @ s
devil	d E v @ l
devon	d E v @ n
devoted	d i v @u t @ d
devout	d i v au t
dewitt	d @ v @ t
dewitt	d @ w @ t
dfa	d i: E f @i
dht	d i: @i tS t i:
di	d ai
diacritic	d ai @ k r\ @ t i k
diacritics	d ai @ k r\ @ t i k s
diagram	d ai @ g r\ { m
dialects	d ai @ l E k t s
diameter	d ai { m @ t @ r\
diamond	d ai @ m @ n d
diamonds	d ai @ m @ n d z
diatomic	d ai @ t Q m i k
dick	d i k
dictator	d i k t @i t @ r\
dictatorship	d i k t @i t @ S @ p
dictionaries	d i k S @ n r\ i z
dictionary	d i k S @ n r\ i
did	d @ d
didactician	d i d { k t i S @ n
didn	d i d @ n
died	d ai d
diego	d i @i g @u
dien	d ai n
diesel	d i: z @ l
diff	d @ f
differ	d @ f @ r\
differed	d @ f @ d
difference	d @ f r\ @ n s
differences	d @ f r\ @ n s @ s
different	d @ f r\ @ n t
differential	d @ f @ r\ E n S @ l
difficult	d i f i k @ l t
diffie	d i f ai
diffusion	d @ f j u: Z @ n
digimon	d i d_0Z i m @ n
digital	d i d_0Z @ t @ l
digress	d ai g r\ E s
dilation	d ai l @i S @ n
dillingen	d i l i N @ n
dillon	d i l @ n
dilute	d ai l j u: t
dimensional	d i m E n S @ n @ l
dino	d ai n @u
dinosaur	d ai n @ s O: r\
dinosaurs	d ai n @ s O: z
dio	d ai @
diocese	d ai @ s @ s
diol	d ai l
dionysius	d ai n i z i@ s
dioxide	d ai Q k s ai d
diploma	d i p l @u m @
diplomatic	d @ p l @ m { t i k
diplomats	d @ p l @ m { t s
dipole	d ai p @u l
dipoles	d ai p @u l z
dirac	d i r\ { k
direct	d i r\ E k t
direction	d i r\ E k S @ n
directions	d i r\ E k S @ n z
directives	d i r\ E k t @ v z
directly	d i r\ E k t l i
director	d i r\ E k t @ r\
directorate	d i r\ E k t @ r\ @ t
directors	d i r\ E k t @ z
directory	d i r\ E k t @ r\ i
dirk	d 3: k
disability	d @ s @ b @ l @ t i
disadvantaged	d @ s @ d v { n t @i d_0Z d
disambiguation	d @ s { m b i g U @i S @ n
disappears	d @ s @ p i@ z
disarmament	d i s A: m @ m @ n t
discharges	d @ s tS A: d_0Z @ z
disciples	d i s ai p @ l z
discipline	d @ s @ p l @ n
disco	d i s k @u
discordian	d i s k O: d i@ n
discounted	d i s k au n t @ d
discovered	d i s k a v @ d
discoverers	d i s k a v @ r\ @ z
discovers	d i s k a v @ z
discrete	d @ s k r\ i: t
discrimination	d @ s k r\ @ m @ n @i S @ n
discussed	d i s k a s t
disease	d i z i: z
diseases	d i z i: z @ z
disengagement	d @ s E n g @i d_0Z m @ n t
disestablished	d i s i s t { b l i S t
disfranchised	d @ s f r\ { n tS ai z d
disk	d @ s k
dismay	d i s m @i
disney	d @ z n i
disorder	d i s O: d @ r\
disorders	d i s O: d @ z
disp	d @ s p
disp	d @ s p l @i
disparate	d @ s p @ r\ @ t
dispersed	d i s p 3: s t
dispersion	d i s p 3: S @ n
displacement	d @ s p l @i s m @ n t
display	d @ s p l @i
displayed	d @ s p l @i d
displays	d @ s p l @i z
disposal	d i s p @u z @ l
dispute	d i s p j u: t
disputed	d i s p j u: t @ d
disputes	d i s p j u: t s
disruptors	d @ s r\ a p t @ z
dissidents	d @ s @ d @ n t s
distance	d @ s t @ n s
distances	d @ s t @ n s @ s
distinct	d i s t i N k t
distinction	d i s t i N k S @ n
distinctive	d i s t i N k t @ v
distinguished	d i s t i N g w i S t
distinguishes	d i s t i N g w i S @ z
distortion	d i s t O: S @ n
distraught	d @ s t r\ O: t
distributed	d @ s t r\ i b j u: t @ d
distribution	d @ s t r\ i b j u: S @ n
district	d @ s t r\ i k t
districts	d @ s t r\ i k t s
disturbances	d i s t 3: b @ n s @ s
ditko	d @ t k @u
divi	d i v ai
divide	d i v ai d
divided	d i v ai d @ d
divine	d i v ai n
division	d i v i Z @ n
divisional	d i v i Z @ n @ l
divisions	d i v i Z @ n z
divisor	d i v ai z @ r\
divulging	d ai v a l d_0Z i N
djibouti	d_0Z i b u: t i
dm	d i: E m
dna	d i: E n @i
do	d @u
dobsenville	d Q b s @ n v @ l
docklands	d Q k l @ n d z
doctor's	d Q k t @ r\ z
doctors	d Q k t @ z
doctrine	d Q k t r\ @ n
document	d Q k j U m @ n t
documentary	d Q k j U m E n t @ r\ i
documentation	d Q k j U m E n t @i S @ n
documents	d Q k j U m @ n t s
dodecahedron	d @u d @ k @ h\ i d r\ @ n
dodgers	d Q d_0Z @ z
does	d a z
does	d @u z
doesn	d a s @ n
dog	d Q g
doing	d u: i N
dolce	d Q l tS @i
dollar	d Q l @ r\
dollst	d Q l s t
dollst	d Q l s t r\ i: t
dolly	d Q l i
domain	d @u m @i n
domestic	d @ m E s t i k
dominee	d Q m i n i
dominica's	d Q m i n i k A: z
dominican	d Q m @ n i k @ n
don	d Q n
don't	d @u n t
donald	d Q n @ l d
donate	d @u n @i t
donative	d @u n @ t @ v
donel	d Q n @ l
doodle	d u: d @ l
dopamine	d Q p { m @ n
doping	d @u p i N
dorje	d O: d_0Z i
dorothea	d Q r\ @ T i@
dorothy	d Q r\ @ T i
dosage	d @u s i d_0Z
dost	d a s t
dostoyevsky	d Q s t Q j E f s k i
dostum	d Q s t @ m
dot	d Q t
dotted	d Q t @ d
double	d a b @ l
doubleday	d a b @ l d @i
doubt	d au t
douglas	d a g l @ s
dover	d @u v @ r\
downtown	d au n t au n
doyle	d Oi l
dozen	d a z @ n
dpg	d i: p i: d_0Z i:
draft	d r\ A: f t
dragons	d r\ { g @ n z
dragunov	d r\ { g a n Q f
drake	d r\ @i k
drama	d r\ A: m @
dramatic	d r\ @ m { t i k
dramatists	d r\ { m @ t @ s t s
drastically	d r\ { s t i k l i
drawings	d r\ O: i N z
drawn	d r\ O: n
dream	d r\ i: m
dreamworks	d r\ i: m w 3: k s
drew's	d r\ u: z
drift	d r\ @ f t
drinking	d r\ i N k i N
drinks	d r\ i N k s
drive	d r\ ai v
driven	d r\ @ v @ n
driver	d r\ ai v @ r\
drives	d r\ ai v z
driving	d r\ ai v i N
drove	d r\ @u v
drover	d r\ @u v @ r\
drug	d r\ a g
drugs	d r\ a g z
drumming	d r\ a m i N
drummond's	d r\ a m @ n d s
drunman	d r\ a n m @ n
drusus	d r\ s @ s
dry	d r\ ai
ds	d i: E s
ds	d u@ m @ n i
du	d u:
dualistic	d j u: @ l i s t i k
duality	d j U { l @ t i
dub	d a b
dubby	d a b i
dubious	d j u: b i@ s
dublin	d a b l @ n
duchy	d a tS i
due	d j u:
duff	d a f
duke	d j u: k
dukes	d j u: k s
dulles	d a l z
duncan	d a n k @ n
dundee	d a n d i
dunfermline	d a n f 3: m l @ n
dung	d a N
dunkeld	d a n k E l d
duovox	d j U @u v Q k s
dup	d j U p
duplicate	d j u: p l i k @ t
durban	d 3: b @ n
durrani	d U r\ A: n i
dutch	d a tS
dutton	d a t @ n
duty	d j u: t i
dvd	d i: v i: d i:
dyke	d ai k
dylan	d @ l @ n
dynamic	d ai n { m i k
dynamics	d ai n { m i k s
dynasty	d @ n @ s t i
dynevor	d ai n E v @ r\
dystopian	d @ s t @u p i@ n
e	i:
eagle	i: g @ l
eagles	i: g @ l z
ealdred	i: l d r\ @ d
earlier	3: l i@ r\
earliest	3: l i @ s t
early	3: l i
earned	3: n d
earner	3: n @ r\
earnings	3: n i N z
ears	i@ z
earth	3: T
earth's	3: T s
earthly	3: T l i
earthquake	3: T k w @i k
eas	i: @i E s
easily	i: z @ l i
east	i: s t
eastbournians	i: s b @ n i@ n z
eastern	i: s t @ n
eats	i: t s
ebert	i@ b @ t
ecclesiastica	i k l i: s i { s t i k @
ecclesiastical	i k l i: s i { s t i k @ l
echelon	E S @ l Q n
echo	E k @u
eclipse	i k l @ p s
economic	i: k @ n Q m i k
economically	i: k @ n Q m i k l i
economics	i: k @ n Q m i k s
economies	i k Q n @ m i z
economist	i k Q n @ m @ s t
economists	i k Q n @ m @ s t s
economy	i k Q n @ m i
ecowas	i: k au Q z
ecsc	i: s i: E s s i:
ect	i: s i: t i:
ecuador	E k w @ d O: r\
ecuadorian	E k w @ d O: r\ i@ n
ecumenical	i: k j u: m E n i k @ l
ed	E d
edda	E d @
eddie	E d i
eddy	E d i
edema	i d m @
edenvale	i: d E n v @i l
edenville	i: d E n v @ l
edgar	E d g @ r\
edge	E d_0Z
edges	E d_0Z @ z
edible	E d @ b @ l
edinburgh	E d @ n b a r\ @
edison	E d @ s @ n
editing	E d @ t i N
edition	i d i S @ n
editions	i d i S @ n z
editor	E d @ t @ r\
editors	E d @ t @ z
edmund	E d m @ n d
educated	E d_0Z U k @i t @ d
education	E d_0Z U k @i S @ n
educational	E d_0Z U k @i S @ n @ l
educators	E d_0Z U k @i t @ z
edward	E d w @ d
edward's	E d w @ d z
edwards	E d w @ d z
edwin	E d w @ n
edwind	E d w @ n d
eea	i: i: @i
eec	i: i: s i:
eez	i: i: z E t
eez	i: i: z i:
effect	i f E k t
effective	i f E k t @ v
effectively	i f E k t @ v l i
effects	i f E k t s
efficient	i f i S @ n t
efficiently	i f i S @ n t l i
effort	E f @ t
efforts	E f @ t s
eggs	E g z
egypt	i: d_0Z @ p t
egyptian	i d_0Z @ p S @ n
ehud	E h\ a d
eighteenth	@i t i: n T
eightfold	@i t f @u l d
eighth	@i t T
eighty	@i t i
einstein	ai n s t ai n
eisner	ai s n @ r\
ejected	i d_0Z E k t @ d
ejections	i d_0Z E k S @ n z
ek	i: k @i
el	@ l
elastic	i l { s t i k
elder	E l d @ r\
eldorado	E l d @ r\ A: d @u
elected	i l E k t @ d
election	i l E k S @ n
elections	i l E k S @ n z
elective	i l E k t @ v
electoral	i l E k t @ r\ @ l
electric	i l E k t r\ i k
electrical	i l E k t r\ i k @ l
electrically	i l E k t r\ i k l i
electricity	i l E k t r\ @ s @ t i
electroconvulsive	i l E k t r\ @u k Q n v a l s @ v
electrode	i l E k t r\ @u d
electromagnetic	i l E k t r\ @u m { g n E t i k
electron	i l E k t r\ Q n
electronic	i l E k t r\ Q n i k
electronically	i l E k t r\ Q n i k l i
electronics	i l E k t r\ Q n i k s
electronium	i l E k t r\ @u n i@ m
electrons	i l E k t r\ Q n z
electrophoresis	i l E k t r\ @u f O: r\ i: s @ s
electrotechnical	i l E k t r\ @u t E k n i k @ l
elektra	E l k t r\ @
elementary	E l i m E n t @ r\ i
elements	E l @ m @ n t s
elephant	E l @ f @ n t
elevated	E l @ v @i t @ d
elgar	E l g @ r\
elgar's	E l g A: r\ z
eli	i: l ai
eliff	i l @ f
eliminate	i l @ m @ n @i t
elite	i l i: t
elizabeth	i l @ z @ b @ T
elliptic	i l @ p t i k
elves	E l v z
elvis	E l v @ s
em	@ m
emancipation	E m { n s @ p @i S @ n
embassy	E m b @ s i
embryo	E m b r\ i @u
embryonic	E m b r\ i Q n i k
emerged	E m 3: d_0Z d
emergency	E m 3: d_0Z @ n s i
emerging	E m 3: d_0Z i N
emerson	E m @ s @ n
emigration	E m i g r\ @i S @ n
emigree	E m i g r\ @i
emily	E m @ l i
emirates	E m @ r\ @ t s
emirs	E m i@ z
emission	E m i S @ n
emissions	E m i S @ n z
emissivity	E m @ s @ v @ t i
emmanuel	i: m { n j U E l
emmy	E m i
emotion	E m @u S @ n
emperor	E m p @ r\ @ r\
emperor's	E m p @ r\ O: r\ z
emperors	E m p @ r\ @ z
empire	E m p ai @ r\
empire's	E m p ai @ z
empires	E m p ai @ z
employed	E m p l Oi d
employees	E m p l Oi i: z
employer	E m p l Oi @ r\
employers	E m p l Oi @ z
employment	E m p l Oi m @ n t
empresses	E m p r\ @ s @ s
emsworth	E m z w 3: T
en	Q N
enabled	E n @i b @ l d
enabling	E n @i b l i N
encountered	E n k au n t @ d
encryption	E n k r\ @ p S @ n
end	E n d
endangered	E n d @i n d_0Z @ d
ended	E n d @ d
ending	E n d i N
endings	E n d i N z
endocrine	E n d @ k r\ i: n
endoplasmic	E n d @ p l { z m i k
endowment	E n d au m @ n t
ends	E n d z
enduring	E n d j u@ r\ i N
energy	E n @ d_0Z i
enforcement	E n f O: s m @ n t
engine	E n d_0Z @ n
engineer	E n d_0Z i n i@ r\
engineering	E n d_0Z i n i@ r\ i N
engineers	E n d_0Z i n i@ z
engines	E n d_0Z @ n z
england	i N l @ n d
english	i N l i S
enhanced	E n h\ A: n s t
enhancing	E n h\ A: n s i N
enigmatic	E n @ g m { t i k
enjoy	E n d_0Z Oi
enjoyed	E n d_0Z Oi d
enjoys	E n d_0Z Oi z
enriched	E n r\ i tS t
enrichment	E n r\ i tS m @ n t
enrico	E n r\ i: k @u
enrollment	E n r\ @u l m @ n t
enshrinees	E n S r\ ai n i: z
enslaved	E n s l @i v d
ensuing	E n s j u: i N
ensuring	E n S u@ r\ i N
entered	E n t @ d
entering	E n t @ r\ i N
enterprise	E n t @ p r\ ai z
enterprises	E n t @ p r\ ai z @ z
entertainment	E n t @ t @i n m @ n t
entire	E n t ai @ r\
entirely	E n t ai @ l i
entitled	E n t ai t @ l d
entity	E n t @ t i
entr	E n t @ r\
entrants	E n t r\ @ n t s
entropy	E n t r\ @ p i
entrusts	E n t r\ a s t s
entry	E n t r\ i
entury	E n tS @ r\ i
environment	E n v ai @ r\ @ n m @ n t
environmental	E n v ai @ r\ @ n m E n t @ l
environments	E n v ai @ r\ @ n m @ n t s
envoy	E n v Oi
enzo	E n z @u
ep	E p
epa	i: p i: @i
ephemeral	@ f E m @ r\ @ l
epic	E p i k
epigrammatists	E p i g r\ { m @ t @ s t s
epirotes	E p ai r\ @u t s
epirus	E p ai r\ @ s
epirus	E p i r\ @ s
episcopal	E p @ s k @ p @ l
episodal	E p i s @u d @ l
episodes	E p i s @u d z
epistemological	E p @ s t @ m @ l Q d_0Z i k @ l
epoxide	E p Q k s ai d
epsom	E p s @ m
equal	i: k w @ l
equally	i: k w @ l i
equation	i k w @i Z n
equations	i k w @i Z n z
equatorial	E k w @ t O: r\ i@ l
equilibrium	i: k w i l i b r\ i@ m
equine	E k w ai n
equipment	i k w @ p m @ n t
equity	E k w @ t i
equivalent	i k w @ v @ l @ n t
equus	i k w j u@ s
er	i: A: r\
era	i@ r\ @
eras	i@ r\ a z
erc	i: A: r\ s i:
eritrea	E r\ @ t r\ @i @
ermelo	3: m @ l u@
eros	i r\ @u z
error	E r\ @ r\
eruptions	i r\ a p S @ n z
es	E z
es	i: E s
esa	i: E s @i
escarpment	i s k A: p m @ n t
eschatology	E s k @ t Q l @ d_0Z i
especially	i s p E S @ l i
espionage	E s p i@ n A: Z
essay	E s @i
essayists	E s @i @ s t s
essays	E s @i z
essential	i s E n S @ l
essentially	i s E n S @ l i
establish	i s t { b l i S
established	i s t { b l i S t
establishing	i s t { b l i S i N
estate	i s t @i t
este	i: E s t i: i:
esteem	i s t i: m
estimated	E s t @ m @i t @ d
estimates	E s t @ m @ t s
et	E t
et	i: t i:
eth	i: t i: @i tS
ethertype	i: T @ t ai p
ethics	E T i k s
ethiopian	i: T i @u p i@ n
ethnic	E T n i k
ethnological	E T n @ l Q d_0Z i k @ l
etonians	E t @u n i@ n z
eu	i: j u:
euclidean	j u: k l @ d i@ n
eugen	j u: d_0Z E n
eugene's	j u: d_0Z i: n z
eugenicists	j u: d_0Z E n @ s @ s t s
eugenics	j u: d_0Z E n i k s
euler	j u: l @ r\
euler	Oi l @ r\
eure	j u@ r\
euro	j u@ r\ @u
eurobarometer	j u@ r\ @u b @ r\ Q m @ t @ r\
europa	j u@ r\ @u p @
europe	j u@ r\ @ p
european	j u@ r\ @ p i@ n
europeans	j u@ r\ @ p i@ n z
eurovision	j u@ r\ @ v i Z @ n
ev	i: v i:
evade	i v @i d
evangelical	i: v { n d_0Z E l i k @ l
evangelion	i v { n d_0Z i: l i@ n
evaton	i v @i t @ n
evening	i: v @ n i N
event	i v E n t
events	i v E n t s
eventual	i v E n tS u@ l
everton	E v @ t @ n
everton's	E v @ t @ n z
every	E v r\ i
evidence	E v @ d @ n s
evidences	E v @ d @ n s @ s
evil	i: v @ l
evolution	i: v @ l u: S @ n
evolutionarily	i: v @ l u: S @ n @ r\ @ l i
evolutionary	i: v @ l u: S @ n r\ i
ewart	i: w A: r\ t
ex	E k s
exacerbate	E g z { s @ b @i t
exact	E g z { k t
exam	E g z { m
examination	E g z { m @ n @i S @ n
examiners	E g z { m @ n @ z
example	E g z A: m p @ l
examples	E g z A: m p @ l z
exceptions	E k s E p S @ n z
excess	E k s E s
exchange	E k s tS @i n d_0Z
exchanges	E k s tS @i n d_0Z @ z
excise	E k s ai z
excitation	E k s ai t @i S @ n
excitatory	E k s ai t @ t @ r\ i
excluding	E k s k l u: d i N
exclusion	E k s k l u: Z @ n
exclusive	E k s k l u: s @ v
excuses	E k s k j u: s @ s
executable	E k s @ k j U t @ b @ l
executed	E k s i k j u: t @ d
executed	E k s @ k j U t @ d
executive	E g z E k j U t @ v
exercises	E k s @ s ai z @ z
exeter	E k s @ t @ r\
exhaustive	E g z O: s t @ v
exhorts	E g z O: t s
exist	E g z @ s t
existed	E g z @ s t @ d
existence	E g z @ s t @ n s
exit	E k s @ t
expanded	E k s p { n d @ d
expatriates	E k s p { t r\ i@ t s
expectancy	E k s p E k t @ n s i
expectation	E k s p E k t @i S @ n
expedition	E k s p @ d i S @ n
expeditionary	E k s p @ d i S @ n @ r\ i
expellees	E k s p E l i: z
expenses	E k s p E n s @ s
expensive	E k s p E n s @ v
experience	E k s p i@ r\ i@ n s
experienced	E k s p i@ r\ i@ n s t
experiences	E k s p i@ r\ i@ n s @ s
experiment	E k s p E r\ @ m @ n t
experimental	E k s p E r\ i m E n t @ l
experts	E k s p 3: t s
explains	E k s p l @i n z
explanatory	E k s p l { n @ t r\ i
exploration	E k s p l @ r\ @i S @ n
explorer	E k s p l O: r\ @ r\
explorers	E k s p l O: r\ @ z
explosion	E k s p l @u Z @ n
explosive	E k s p l @u s @ v
exponentiate	E k s p @ n E n S i @i t
export	E k s p O: t
exporting	E k s p O: t i N
exports	E k s p O: t s
express	E k s p r\ E s
expressed	E k s p r\ E s t
expresses	E k s p r\ E s @ s
expressing	E k s p r\ E s i N
expression	E k s p r\ E S @ n
expressive	E k s p r\ E s @ v
extended	E k s t E n d @ d
extension	E k s t E n S @ n
extensive	E k s t E n s @ v
exterior	E k s t i@ r\ i@ r\
external	E k s t 3: n @ l
extinct	E k s t i N k t
extinction	E k s t i N k S @ n
extra	E k s t r\ @
extracellular	E k s t r\ @i s E l j U l @ r\
extrajudicial	E k s t r\ @ d_0Z u: d i S @ l
extremely	E k s t r\ i: m l i
eyck	ai k
eye	ai
eyes	ai z
f	E f
fa	f A:
faa	E f @i @i
fabrication	f { b r\ i k @i S @ n
faced	f @i s t
facie	f @i s i
facilitated	f @ s @ l @ t @i t @ d
facilitating	f @ s @ l @ t @i t i N
facilities	f @ s @ l @ t i z
facility	f @ s @ l @ t i
facing	f @i s i N
fact	f { k t
faction	f { k S @ n
factor	f { k t @ r\
factorization	f { k t @ r\ ai z @i S @ n
factory	f { k t @ r\ i
facts	f { k t s
faculty	f { k @ l t i
faculty's	f { k @ l t i z
faded	f @i d @ d
fagoth	f { g @ T
fahrenheit	f { r\ @ n h\ ai t
failed	f @i l d
failure	f @i l j @ r\
fair	f e@ r\
fairly	f e@ l i
fairport	f e@ p O: t
faith	f @i T
falcon	f { l k @ n
fallacies	f { l @ s i s
fallout	f O: l au t
falls	f O: l z
false	f O: l s
fame	f @i m
famed	f @i m d
families	f { m @ l i z
family	f { m @ l i
famine	f { m @ n
famous	f @i m @ s
fan	f { n
fandom	f { n d @ m
fanfare	f { n f e@ r\
fans	f { n z
fantasy	f { n t @ s i
fanzines	f { n z ai n z
fao	E f @i @u
far	f A: r\
farm	f A: m
farming	f A: m i N
fascist	f { s @ s t
fashion	f { S @ n
fast	f A: s t
fated	f @i t @ d
father	f A: D @ r\
father's	f A: D @ r\ z
fathers	f A: D @ z
fatty	f { t i
fault	f O: l t
fauna	f O: n @
favourable	f @i v @ r\ @ b @ l
fawkes	f O: k s
fbi	E f b i: ai
fc	E f s i:
fcc	E f s i: s i:
fda	E f d i: @i
fdi	E f d i: ai
fe	E f i:
fears	f i@ z
feathered	f E D @ d
feathers	f E D @ z
feature	f i: tS @ r\
featured	f i: tS @ d
features	f i: tS @ z
featuring	f i: tS @ r\ i N
february	f E b j u@ r\ i
february	f E b r\ u@ r\ i
federal	f E d @ r\ @ l
federalism	f E d @ r\ @ l @ z @ m
federally	f E d r\ @ l i
federation	f E d @ r\ @i S @ n
federative	f E d @ r\ @i t @ v
feet	f i: t
fell	f E l
fellini	f E l i: n i
fellow	f E l @u
fellows	f E l @u z
female	f i: m @i l
fencers	f E n s @ z
ferdinand	f @ d i n { n d
fermi	f @ r\ m i
fernando	f 3: n { n d @u
ferndale	f 3: n d @i l
ferry	f E r\ i
fertile	f 3: t ai l
fertility	f @ t @ l @ t i
fertilized	f 3: t @ l ai z d
ferus	f E r\ @ s
festival	f E s t @ v @ l
festivals	f E s t @ v @ l z
fever	f i: v @ r\
fft	E f E f t i:
fi	f i:
fiba	f i: b @
fiber	f ai b @ r\
fiction	f i k S @ n
fictional	f i k S @ n @ l
fidel	f i d E l
field	f i: l d
fields	f i: l d z
fierce	f i@ s
fifa	f i: f a
fifteenth	f @ f t i: n T
fifth	f @ f T
fifths	f @ f T s
fifty	f @ f t i
fight	f ai t
fighter	f ai t @ r\
fighting	f ai t i N
figure	f i g @ r\
file	f ai l
files	f ai l z
filippo	f @ l @ p @u
film	f @ l m
film's	f @ l m z
filming	f @ l m i N
filmmakers	f @ l m @i k @ z
films	f @ l m z
filter	f @ l t @ r\
filters	f @ l t @ z
final	f ai n @ l
finalizers	f ai n @ l ai z @ z
finally	f ai n @ l i
finals	f ai n @ l z
finance	f ai n { n s
financial	f ai n { n S @ l
finds	f ai n d z
fine	f ai n
finely	f ai n l i
finger	f i N g @ r\
finish	f i n i S
finite	f ai n ai t
finland	f @ n l @ n d
finland's	f @ n l @ n d z
finnish	f @ n i S
fire	f ai @ r\
firearm	f ai @ r\ A: m
firm	f 3: m
first	f 3: s t
fiscal	f @ s k @ l
fish	f i S
fisher	f i S @ r\
fishing	f i S i N
fiske	f @ s k
fission	f i S @ n
five	f ai v
fixed	f i k s t
fixtures	f i k s tS @ z
flagship	f l { g S @ p
flannery	f l { n @ r\ i
flash	f l { S
flat	f l { t
flavors	f l @i v @ z
flaw	f l O:
fled	f l E d
fleece	f l i: s
fleet	f l i: t
flight	f l ai t
flightless	f l ai t l @ s
floating	f l @u t i N
floodlit	f l a d l @ t
floor	f l O: r\
floppy	f l Q p i
flora	f l O: r\ @
florence	f l Q r\ @ n s
florentine	f l Q r\ E n t ai n
florentine	f l Q r\ E n t i: n
florida	f l Q r\ i d @
flow	f l @u
flowed	f l @u d
flows	f l @u z
fluctuates	f l a k tS U @i t s
fluently	f l u: @ n t l i
fluid	f l u: @ d
fluorescence	f l u@ r\ E s @ n s
flying	f l ai i N
fm	E f E m
fmri	E f E m A: r\ ai
focal	f @u k @ l
fochville	f Q k v @ l
focus	f @u k @ s
focused	f @u k @ s t
foeda	f @u i: d @
folk	f @u k
follow	f Q l @u
followed	f Q l @u d
following	f Q l @u i N
food	f u: d
foods	f u: d z
football	f U t b O: l
footballer	f U t b O: l @ r\
footnotes	f U t n @u t s
for	f O: r\
force	f O: s
forced	f O: s t
forces	f O: s @ s
forcing	f O: s i N
ford	f O: d
ford's	f O: d z
foreign	f Q r\ @ n
forest	f Q r\ @ s t
forestall	f O: s t O: l
forestry	f Q r\ @ s t r\ i
forestt	f Q r\ @ s t
forever	f @ r\ E v @ r\
form	f O: m
formable	f O: m @ b @ l
formal	f O: m @ l
formalised	f O: m @ l ai s d
formally	f O: m @ l i
forman	f O: m @ n
format	f O: m { t
formation	f O: m @i S @ n
formations	f O: m @i S @ n z
formats	f O: m { t s
formed	f O: m d
former	f O: m @ r\
forming	f O: m i N
forms	f O: m z
formula	f O: m j U l @
formulated	f O: m j U l @i t @ d
formulation	f O: m j U l @i S @ n
fort	f O: t
forth	f O: T
fortier	f O: t i@ r\
fortress	f O: t r\ @ s
forts	f O: t s
fortune	f O: tS u: n
forty	f O: t i
forum	f O: r\ @ m
forward	f O: w @ d
fossil	f Q s @ l
fossils	f Q s @ l z
foucault	f U k a l t
foucault	f U k @u
foundation	f au n d @i S @ n
foundation's	f au n d @i S @ n z
founded	f au n d @ d
founder	f au n d @ r\
founders	f au n d @ z
four	f O: r\
fourier	f O: r\ i@ r\
fourth	f O: T
fourty	f O: t i
fox	f Q k s
fp	E f p i:
fpu	E f p i: j u:
fr	E f A: r\
fractal	f r\ { k t @ l
fraenkel	f r\ { n k @ l
frame	f r\ @i m
framed	f r\ @i m d
frames	f r\ @i m z
framework	f r\ @i m w 3: k
france	f r\ A: n s
france's	f r\ A: n s @ z
francesca	f r\ { n tS E s k @
franchise	f r\ { n tS ai z
franchises	f r\ { n tS ai z @ z
francis	f r\ A: n s @ s
franciscan	f r\ { n s @ s k @ n
francisco	f r\ { n s i s k @u
franco	f r\ { n k @u
franco's	f r\ { N k @u z
francophonie	f r\ { N k @ f @u n i
frank	f r\ { N k
frankfort	f r\ { N k f O: t
frankfurt	f r\ { N k f 3: t
frankish	f r\ { N k i S
franklin	f r\ { N k l @ n
franz	f r\ a n z
franz	f r\ { n z
frederick	f r\ E d r\ i k
frederick's	f r\ E d r\ i k s
frederik	f r\ E d r\ i k
fredkin	f r\ E d k @ n
free	f r\ i
freedom	f r\ i: d @ m
freedomland	f r\ i: d @ m l { n d
freedompark	f r\ i: d @ m p A: k
freely	f r\ i: l i
freestate	f r\ i: s t @i t
french	f r\ E n tS
frensch	f r\ E n S
frequency	f r\ i: k w @ n s i
frequent	f r\ i: k w @ n t
frequently	f r\ i: k w @ n t l i
freshwater	f r\ E S w O: t @ r\
friction	f r\ i k S @ n
friday	f r\ ai d @i
frideric	f r\ ai d E r\ i k
fried	f r\ ai d
friedman	f r\ i: d m @ n
friedrich	f r\ i: d r\ i k
friendly	f r\ E n d l i
friends	f r\ E n d z
fringe	f r\ i n d_0Z
frisian	f r\ i: z i@ n
from	f r\ Q m
frontier	f r\ a n t i@ r\
fruit	f r\ u: t
fruited	f r\ u: t @ d
ft	E f t i:
fta	E f t i: @i
fuego	f j u: g @u
fuel	f j u: @ l
fueled	f j u: l d
fuels	f j u: @ l z
fulfilling	f U l f i l i N
fully	f U l i
fuming	f j u: m i N
function	f a N k S @ n
functional	f a N k S @ n @ l
functioning	f a N k S @ n i N
functions	f a N k S @ n z
fund	f a n d
fundamental	f a n d @ m E n t @ l
funding	f a n d i N
funds	f a n d z
furniture	f 3: n i tS @ r\
further	f 3: D @ r\
furthered	f 3: D @ d
fusiliers	f j u: s @ l i@ z
fusion	f j u: Z @ n
future	f j u: tS @ r\
g	d_0Z i:
gaelic	g @i l i k
gaels	g @i l z
gaeltacht	g @i l t a k t
gage	g @i d_0Z
gaiman	g @i m @ n
gain	g @i n
gained	g @i n d
gains	g @i n z
gaius	g @i i@ s
galaxies	g { l @ k s i s
galaxy	g { l @ k s i
galba's	g { l b @ z
galbraith	g { l b r\ @i T
galerius	g @ l i@ r\ i@ s
gall	g { l
gall	g O: l
galleons	g { l i@ n z
gallery	g { l @ r\ i
gallium	g { l i@ m
gambling	g { m b l i N
game	g @i m
games	g @i m z
gametes	g { m i: t s
gamma	g { m @
gana	g A: n @
gandhi	g a n d i
gandhi	g { n d i
ganglia	g { N g l i@
gap	g { p
garbage	g A: b i d_0Z
garden	g A: d @ n
gardening	g A: d n i N
gardens	g A: d @ n z
garland	g A: l @ n d
garlina	g A: l i: n @
garner	g A: n @ r\
garrick	g { r\ i k
garry	g { r\ i
garter	g A: t @ r\
gary's	g { r\ i z
gas	g { s
gascon	g { s k @ n
gases	g { s @ s
gaston	g { s t @ n
gate	g @i t
gates	g @i t s
gauge	g @i d_0Z
gauss	g au s
gave	g @i v
gay	g @i
gdp	d_0Z i: d i: p i:
gear	g i@ r\
geelong	d_0Z @ l Q N
gel	d_0Z E l
gell	d_0Z E l
gell	g E l
gem	d_0Z E m
gender	d_0Z E n d @ r\
gene	d_0Z i: n
genera	d_0Z E n @ r\ @
general	d_0Z E n r\ @ l
general's	d_0Z E n @ r\ @ l z
generalized	d_0Z E n r\ @ l ai z d
generally	d_0Z E n r\ @ l i
generals	d_0Z E n @ r\ @ l z
generals	d_0Z E n r\ @ l z
generate	d_0Z E n @ r\ @i t
generated	d_0Z E n @ r\ @i t @ d
generates	d_0Z E n @ r\ @i t s
generator	d_0Z E n @ r\ @i t @ r\
generators	d_0Z E n @ r\ @i t @ z
generic	d_0Z i n E r\ i k
genesis	d_0Z E n @ s @ s
genetic	d_0Z i n E t i k
genetically	d_0Z i n E t i k l i
genital	d_0Z E n @ t @ l
genome	d_0Z i: n @u m
genre	Z A: n r\ @
genres	Z A: n r\ @ z
gentis	d_0Z E n t @ s
gentleman	d_0Z E n t @ l m @ n
gently's	d_0Z E n t l i z
genuine	d_0Z E n j U @ n
geo	d_0Z E @u
geoffrey	d_0Z E f r\ i
geographic	d_0Z i @u g r\ { f i k
geographical	d_0Z i@ g r\ { f i k @ l
geography	d_0Z i Q g r\ @ f i
geologic	d_0Z i@ l Q d_0Z i k
geological	d_0Z i@ l Q d_0Z i k @ l
geologists	d_0Z i Q l @ d_0Z @ s t s
geometers	d_0Z i@ Q m @ t @ z
geometry	d_0Z i Q m @ t r\ i
georg	d_0Z O: g
george	d_0Z O: d_0Z
georgetown	d_0Z O: d_0Z t au n
georgian	d_0Z O: d_0Z @ n
georgy	d_0Z O: d_0Z i
gerald	d_0Z E r\ @ l d
gerasimov	g @ r\ { s i m Q f
german	d_0Z 3: m @ n
germania	d_0Z @ m @i n i@
germanic	d_0Z @ m { n i k
germans	d_0Z 3: m @ n z
germany	d_0Z 3: m @ n i
germany's	d_0Z 3: m @ n i z
germiston	d_0Z 3: m @ s t @ n
gershwin	g 3: S w @ n
gertrud	g 3: t r\ U d
gestae	d_0Z E s t i
getro	g E t r\ @u
getrude	g E t r\ u: d
gets	g E t s
getty	g E t i
geum	d_0Z i: @ m
ghafiqi	g @i f i k i
ghats	g O: t s
giant	d_0Z ai @ n t
giant's	d_0Z ai @ n t s
giants	d_0Z ai @ n t s
gibbon	g i b @ n
gibbs	g i b z
gibeon	g i b i@ n
gibson	g i b s @ n
gideon	g i d i @ n
gigs	g i g z
giovanni	d_0Z i @u v a n i
girders	g 3: d @ z
girlfriend	g 3: l f r\ E n d
giuliano	j u: l i A: n @u
given	g i v @ n
gives	g i v z
giving	g i v i N
glacier	g l @i s i@ r\
gladstone	g l { d s t @u n
gland	g l { n d
glasgow	g l A: s g @u
glasgow	g l { z g @u
glass	g l A: s
gleam	g l i: m
global	g l @u b @ l
globe	g l @u b
glory	g l O: r\ i
glove	g l a v
glucose	g l u: k @u s
glynd	g l @ n d
gnaeus	n au s
gnostic	n Q s t i k
gnu	n u:
goal	g @u l
goals	g @u l z
goat	g @u t
gobind	g @u b ai n d
god	g Q d
god's	g Q d z
godalming	g Q d @ l m i N
goddesses	g Q d E s @ s
gods	g Q d z
goes	g @u z
gold	g @u l d
golden	g @u l d @ n
golders	g @u l d @ z
gon	g Q n
good	g U d
google	g u: g @ l
gorbachev's	g O: b @ tS E v z
gordon	g O: d @ n
gordon's	g O: d @ n z
gorge	g O: d_0Z
gorges	g O: d_0Z @ z
gorman	g O: m @ n
gospel	g Q s p @ l
got	g Q t
gothic	g Q T i k
gottfried	g Q t f r\ i d
gould	g u: l d
governing	g a v @ n i N
government	g a v @ n m @ n t
governmental	g a v @ n m E n t @ l
governor	g a v @ n @ r\
governors	g a v @ n @ z
gowron	g au r\ @ n
gpl	d_0Z i: p i: { l
grace	g r\ @i s
grade	g r\ @i d
gradual	g r\ { d_0Z u@ l
gradually	g r\ { d_0Z u@ l i
graduate	g r\ { d_0Z u@ t
graduation	g r\ { d_0Z U @i S @ n
graecia	g r\ i S @
graeme	g r\ i: m
graham	g r\ @i h\ a m
grain	g r\ @i n
grammar	g r\ { m @ r\
grammarians	g r\ @ m e@ r\ i@ n z
grammatical	g r\ @ m { t i k @ l
grammy	g r\ { m i
grand	g r\ { n d
grandmasters	g r\ { n m A: s t @ z
grange	g r\ @i n d_0Z
granny's	g r\ { n i z
grant's	g r\ A: n t s
granted	g r\ A: n t @ d
granth	g r\ A: n t
grants	g r\ A: n t s
graphical	g r\ { f i k @ l
graphics	g r\ { f i k s
graphite	g r\ { f ai t
grassland	g r\ A: s l { n d
grateful	g r\ @i t f @ l
graves	g r\ A: v z
gravitational	g r\ { v @ t @i S @ n @ l
gravitationally	g r\ { v @ t @i S @ n @ l i
gravity	g r\ { v @ t i
gray	g r\ @i
grays	g r\ @i z
great	g r\ @i t
greater	g r\ @i t @ r\
greatest	g r\ @i t @ s t
greatly	g r\ @i t l i
greece	g r\ i: s
greek	g r\ i: k
greeks	g r\ i: k s
green	g r\ i: n
greene	g r\ i: n
greeneville	g r\ i: n v @ l
greenhouse	g r\ i: n h\ au s
greenpeace	g r\ i: n p i: s
greenwich	g r\ E n i tS
gregorian	g r\ @ g O: r\ i@ n
gregory	g r\ E g @ r\ i
grenade	g r\ @ n @i d
grendel's	g r\ E n d E l z
grew	g r\ u:
grey	g r\ @i
greyhound	g r\ @i h\ au n d
griffin's	g r\ @ f i n z
griffith	g r\ @ f i: T
grimes	g r\ ai m z
grinch	g r\ i n S
grint	g r\ @ n t
grisly	g r\ @ z l i
grizzly	g r\ @ z l i
groblersdal	g r\ Q b l @ z d A: l
groblersdal	k r\ Q b l @ r\ s d a l
grohl's	g r\ Q l z
gross	g r\ @u s
grossing	g r\ @u s i N
ground	g r\ au n d
grounded	g r\ au n d @ d
group	g r\ u: p
group's	g r\ u: p s
groups	g r\ u: p s
growing	g r\ @u i N
growth	g r\ @u T
growths	g r\ @u T s
gst	d_0Z i: E s t i:
guano	g w A: n @u
guaranteed	g { r\ @ n t i: d
guarantees	g { r\ @ n t i: z
guard	g A: d
guardian	g A: d i@ n
guardians	g A: d i@ n z
guerrero	g @ r\ E r\ @u
guests	g E s t s
guggenheim	g u: g @ n h\ ai m
gui	d_0Z i: j u: ai
gui	g U i
guide	g ai d
guided	g ai d @ d
guidelines	g ai d l ai n z
guild	g i l d
guillemets	g i j i m E
guillemets	g i l m E t s
guinea	g i n i
guinness	g i n @ s
guis	g j i
guitar	g i t A: r\
guitarist	g i t A: r\ @ s t
guitarists	g i t A: r\ @ s t s
gulf	g a l f
gun	g a n
gundam	g a n d @ m
gunpowder	g a n p au d @ r\
guns	g a n z
guru	g U r\ U
guzman	g a z m @ n
gv	d_0Z i: v i:
gwent	g w E n t
habitat	h\ { b i t { t
habsburg	h\ a p s b 3: g
hackers	h\ { k @ z
had	h\ { d
hadden	h\ { d @ n
haddington	h\ { d i N t @ n
hades	h\ @i d i: z
hadron	h\ { d r\ @ n
hahn	h\ A: n
hahn	h\ { n
haile	h\ @i l
haina	h\ ai n @
hajar	h\ @ d_0Z A: r\
halakha	h\ @ l A: k @
halberstadt	h\ { l b @ s t { t
half	h\ A: f
halicarnassus	h\ { l i k A: n { s @ s
hall	h\ O: l
halleck	h\ { l E k
hallelujah	h\ { l @ l u: j @
ham	h\ { m
hamburg	h\ { m b 3: g
hamid	h\ { m @ d
hamilton	h\ { m @ l t @ n
hammerstein	h\ { m @ s t ai n
hampshire	h\ { m p S @ r\
hampstead	h\ { m p s t E d
hancock	h\ { n k Q k
hand	h\ { n d
handball	h\ { n d b O: l
handel	h\ { n d @ l
handheld	h\ { n d h\ E l d
handle	h\ { n d @ l
hang	h\ { N
hanlon	h\ { n l @ n
hanover	h\ { n @u v @ r\
hans	h\ { n z
haplogroup	h\ { p l @ g r\ u: p
happened	h\ { p @ n d
happens	h\ { p @ n z
harbor	h\ A: b @ r\
harbour	h\ A: b @ r\
hard	h\ A: d
hardee's	h\ A: d i: z
harden	h\ A: d @ n
hardship	h\ A: d S @ p
hardware	h\ A: d w e@ r\
harlan	h\ A: l @ n
harm	h\ A: m
harmed	h\ A: m d
harmonic	h\ A: m Q n i k
harmonium	h\ A: m @u n i@ m
harold	h\ { r\ @ l d
harper's	h\ A: p @ r\ z
harris	h\ { r\ @ s
harrison	h\ { r\ @ s @ n
harrison's	h\ { r\ @ s @ n z
harry	h\ { r\ i
hart	h\ A: t
harvard	h\ A: v @ d
harvey	h\ A: v i
has	h\ { z
hash	h\ { S
hassan	h\ { s { n
hat	h\ { t
have	h\ { v
havel	h\ { v @ l
havelberg	h\ { v l b 3: g
haven	h\ @i v @ n
having	h\ { v i N
hawaiian	h\ @ w ai @ n
hawk	h\ O: k
haydnesque	h\ ai d @ n E s k
haynes	h\ @i n z
hayward	h\ @i w @ d
hayy	h\ @i i
hazard	h\ { z @ d
hazardous	h\ { z @ d @ s
hazards	h\ { z @ d z
hazyview	h\ @i z i: v j u:
hcl	@i tS s i: { l
he	h\ i:
head	h\ E d
headed	h\ E d @ d
header	h\ E d @ r\
heading	h\ E d i N
headquarters	h\ E d k w O: t @ z
heads	h\ E d z
health	h\ E l T
hearst	h\ 3: s t
heart	h\ A: t
hearts	h\ A: t s
heat	h\ i: t
heater	h\ i: t @ r\
heath	h\ i: T
heathrow	h\ i: T r\ @u
heating	h\ i: t i N
heavier	h\ E v i@ r\
heavily	h\ E v i l i
heavy	h\ E v i
hebrew	h\ i: b r\ u:
hebron	h\ E b r\ Q n
hegel	h\ @i g @ l
hegemony	h\ E d_0Z @ m @ n i
hegemony	h\ i g E m @ n i
heian	h\ n
heidelberg	h\ ai d @ l b 3: g
heidi	h\ ai d i
heinz	h\ ai n z
heirs	e@ z
heisenberg	h\ ai z @ n b 3: g
hejaz	h\ i d_0Z { z
held	h\ E l d
helen	h\ E l @ n
helium	h\ i: l i@ m
helix	h\ E l i k s
hell	h\ E l
hellenistic	h\ E l i: n @ s t i k
heller	h\ E l @ r\
hellman	h\ E l m @ n
hello	h\ @ l @u
helmuth	h\ E l m U T
help	h\ E l p
helped	h\ E l p t
helper	h\ E l p @ r\
helps	h\ E l p s
helsinki	h\ E l s i N k i
hendrik	h\ E n d r\ @ k
hendrix	h\ E n d r\ i k s
henri	h\ E n r\ i
henrik	h\ E n r\ @ k
henry	h\ E n r\ i
henson	h\ E n s @ n
hepatitis	h\ E p @ t ai t @ s
herald	h\ E r\ @ l d
herbert	h\ 3: b @ t
here	h\ i@ r\
hereford	h\ E r\ @ f @ d
heresy	h\ E r\ @ s i
heritage	h\ E r\ @ t i d_0Z
herman	h\ 3: m @ n
hermetic	h\ 3: m E t i k
hero	h\ i@ r\ @u
herodotus	h\ E r\ @ d @u t @ s
heroes	h\ i@ r\ @u z
hetatm	h\ @ t @i t @ m
heterodox	h\ E t @ r\ @u d Q k s
hib	h\ i b
hib	@i tS ai b i:
hidden	h\ i d @ n
hiding	h\ ai d i N
high	h\ ai
higher	h\ ai @ r\
highest	h\ ai @ s t
highland	h\ ai l @ n d
highly	h\ ai l i
highway	h\ ai w @i
highways	h\ ai w @i z
hilbert	h\ i l b @ t
hillary	h\ i l @ r\ i
hills	h\ i l z
hims	h\ i m z
hindenburg	h\ i n d @ n b 3: g
hindquarters	h\ i n d k w O: t @ z
hindu	h\ i n d u:
hip	h\ i p
hipper's	h\ i p @ r\ z
hippocamelus	h\ i p @u k { m @ l @ s
hippocampal	h\ i p @u k { m p @ l
hired	h\ ai @ d
his	h\ i z
histochemical	h\ i s t @ k E m @ k @ l
histocompatibility	h\ i s t @u k Q m p { t @ b @ l @ t i
historia	h\ i s t O: r\ i@
historian	h\ i s t O: r\ i@ n
historians	h\ i s t O: r\ i@ n z
historic	h\ i s t Q r\ i k
historical	h\ i s t Q r\ i k @ l
history	h\ i s t r\ i
hit	h\ i t
hitchcock	h\ i tS k Q k
hits	h\ i t s
ho	h\ @u
hoar	h\ O: r\
hoc	h\ Q k
hockey	h\ Q k i
hoek	h\ @u k
holcombe	h\ @ l k @ m
hold	h\ @u l d
holden	h\ @u l d @ n
hole	h\ @u l
holes	h\ @u l z
holidays	h\ Q l @ d @i z
holland	h\ Q l @ n d
hollow	h\ Q l @u
holloway	h\ Q l @ w @i
holly	h\ Q l i
hollywood	h\ Q l i w U d
holmes	h\ @u m z
holy	h\ @u l i
holyoke	h\ @u l i @u k
home	h\ @u m
homeostasis	h\ @u m i @u s t ai s @ s
hondt	h\ Q n t
honey	h\ a n i
hong	h\ Q N
honneur	Q n @ r\
honor	Q n @ r\
honorary	Q n @ r\ @ r\ i
honorees	Q n @ r\ i: z
honorius	h\ Q n O: r\ i@ s
honors	Q n @ z
honouring	Q n @ r\ i N
hood	h\ U d
hooker	h\ U k @ r\
hoover	h\ u: v @ r\
hooves	h\ u: v z
hop	h\ Q p
hope	h\ @u p
hopkins	h\ Q p k @ n s
hopper	h\ Q p @ r\
hormone	h\ O: m @u n
hornet	h\ O: n @ t
horns	h\ O: n z
horror	h\ Q r\ @ r\
horse	h\ O: s
horses	h\ O: s @ s
horticulture	h\ O: t i k a l tS @ r\
hospital	h\ Q s p @ t @ l
host	h\ @u s t
hostage	h\ Q s t i d_0Z
hosting	h\ @u s t i N
hosts	h\ @u s t s
hot	h\ Q t
hotel	h\ @u t E l
hotspots	h\ Q t s p Q t s
hotspur	h\ Q t s p 3: r\
hotter	h\ Q t @ r\
hour	au @ r\
hours	au @ z
house	h\ au s
household	h\ au s h\ @u l d
houses	h\ au z @ z
housing	h\ au z i N
how	h\ au
howard	h\ au w 3: d
however	h\ au E v @ r\
hr	@i tS A: r\
http	@i tS t i: t i: p i:
hu	h\ u:
hubbard	h\ a b @ d
hubbard's	h\ a b @ d z
hubble	h\ a b @ l
hubner	h\ a b n @ r\
hudson	h\ a d s @ n
hue	j u:
huemul	j u: m @ l
huffman	h\ a f m @ n
huge	h\ j u: d_0Z
huge	j u: d_0Z
hugh	j u:
hughes	j u: z
hugo	j u: g @u
hull	h\ a l
human	h\ j u: m @ n
human	j u: m @ n
humanists	j u: m @ n @ s t s
humanitarian	h\ j u: m { n i t e@ r\ i@ n
humanitarian	j u: m { n @ t e@ r\ i@ n
humanitarians	j u: m { n @ t e@ r\ i@ n z
humanities	h\ j u: m { n @ t i z
humanities	j u: m { n @ t i z
humanoid	j u: m @ n Oi d
humans	h\ j u: m @ n z
humans	j u: m @ n z
humboldt	h\ a m b @u l t
hume	j u: m
humid	h\ j u: m @ d
humid	j u: m @ d
humor	j u: m @ r\
humphrey	h\ a m f r\ i
humphry	h\ a m f r\ i
hungarian	h\ a N g e@ r\ i@ n
hungary	h\ a N g @ r\ i
hunt	h\ a n t
hunters	h\ a n t @ z
hurley's	h\ 3: l i z
huxley	h\ a k s l i
hybrids	h\ ai b r\ @ d z
hydrocarbon	h\ ai d r\ @ k A: b @ n
hydrocarbons	h\ ai d r\ @ k A: b @ n z
hydrochloric	h\ ai d r\ @ k l Q r\ i k
hydroelectric	h\ ai d r\ @u i l E k t r\ i k
hydrogen	h\ ai d r\ @ d_0Z @ n
hydrographic	h\ ai d r\ @u g r\ { f i k
hygiene	h\ ai d_0Z i: n
hymn	h\ i m
hymns	h\ i m z
hymnwriters	h\ i m n r\ ai t @ z
hyperactivity	h\ ai p @ r\ { k t @ v @ t i
hyperboloids	h\ ai p @ r\ b Q l Oi d z
hypothesis	h\ ai p Q T @ s @ s
hystricognath	h\ i s t r\ i k @ g n @ t
ia	ai @i
iaea	ai @i i: @i
ian	i@ n
iata	ai @i t i: @i
iau	ai @i j u:
ibm	ai b i: E m
ibn	ai b i: E n
icao	ai s i: @i @u
icc	ai s i: s i:
ice	ai s
icelanders	ai s l { n d @ z
ics	ai s i: E s
icu	ai s i: j u:
id	i d
ideal	ai d i@ l
ideas	ai d i@ z
identification	ai d E n t i f i k @i S @ n
identify	ai d E n t @ f ai
identifying	ai d E n t @ f ai i N
identity	ai d E n t @ t i
ideologies	ai d i Q l @ d_0Z i z
ideology	ai d i Q l @ d_0Z i
idf	ai d i: E f
idler	ai d l @ r\
iec	ai i: s i:
ieee	ai i: i: i:
ietf	ai i: t i: E f
if	i f
ignatians	i g n @i S @ n z
ii	ai ai
ii's	ai ai z
iia	ai ai @i
iii's	ai ai ai z
iiss	ai ai E s E s
ikea	i: k i: a
iliad	i l i { d
ill	i l
illegal	i l i: g @ l
illinois	i l @ n Oi
illustrated	i l @ s t r\ @i t @ d
illustrators	i l @ s t r\ @i t @ z
ilo	ai { l @u
image	i m i d_0Z
imaging	i m i d_0Z i N
imams	i m A: m z
imf	ai E m E f
imitating	i m @ t @i t i N
immeasurable	i m E Z @ r\ @ b @ l
immediate	i m i: d i@ t
immediately	i m i: d i@ t l i
immersion	i m 3: S @ n
immigrants	i m i g r\ @ n t s
immigration	i m i g r\ @i S @ n
immune	i m j u: n
immunity	i m j u: n @ t i
immunodeficiency	i m j U n @u d i f i S @ n s i
immunologicals	i m j U n @ l Q d_0Z i k @ l z
impacts	i m p { k t s
impairment	i m p e@ m @ n t
impasse	{ m p A: s
impassioned	i m p { S @ n d
impeached	i m p i: tS t
imperial	i m p i@ r\ i@ l
implementation	i m p l i m E n t @i S @ n
implementations	i m p l i m E n t @i S @ n z
important	i m p O: t @ n t
imported	i m p O: t @ d
importing	i m p O: t i N
imprecise	i m p r\ @ s ai s
imprint	i m p r\ @ n t
improvements	i m p r\ u: v m @ n t s
improving	i m p r\ u: v i N
improvised	i m p r\ @ v ai z d
in	i n
inc	i N k
inca	i n k @
incendiary	i n s E n d_0Z @ r\ i
incident	i n s @ d @ n t
include	i n k l u: d
included	i n k l u: d @ d
includes	i n k l u: d z
including	i n k l u: d i N
income	i N k a m
incompleteness	i n k @ m p l i: t n @ s
incorporated	i n k O: p @ r\ @i t @ d
incorporating	i n k O: p @ r\ @i t i N
incorrect	i n k @ r\ E k t
increase	i N k r\ i: s
increased	i n k r\ i: s t
increases	i N k r\ i: s @ s
increasing	i n k r\ i: s i N
increasingly	i n k r\ i: s i N l i
indebted	i n d E t @ d
independence	i n d i p E n d @ n s
independent	i n d i p E n d @ n t
independently	i n d i p E n d @ n t l i
index	i n d E k s
india	i n d i@
indian	i n d i@ n
indiana	i n d i { n @
indicated	i n d i k @i t @ d
indicates	i n d i k @i t s
indie	i n d i
indies	i n d i z
indigenous	i n d i d_0Z @ n @ s
indira	i n d i r\ @
indirectly	i n d i r\ E k t l i
indischer	i n d @ S @ r\
individual	i n d i v i d_0Z u@ l
individuals	i n d i v i d_0Z u@ l z
indo	i n d @u
indonesia	i n d @ n i: z i@
inductees	i n d a k t i: z
indus	i n d @ s
industrial	i n d a s t r\ i@ l
industries	i n d @ s t r\ i z
industry	i n d @ s t r\ i
inertial	i n 3: S @ l
infant	i n f @ n t
infantry	i n f @ n t r\ i
infarction	i n f A: k S @ n
infected	i n f E k t @ d
infection	i n f E k S @ n
infectious	i n f E k S @ s
infinitely	i n f @ n @ t l i
inflammatory	i n f l { m @ t r\ i
inflate	i n f l @i t
inflation	i n f l @i S @ n
influence	i n f l u@ n s
influences	i n f l u@ n s @ s
influential	i n f l U E n S @ l
information	i n f @ m @i S @ n
informational	i n f @ m @i S @ n @ l
infrared	i n f r\ e@ d
infrastructural	i n f r\ @ s t r\ a k tS @ r\ @ l
infrastructure	i n f r\ @ s t r\ a k tS @ r\
infuriated	i n f j U r\ i @i t @ d
inga	i N g @
ingredients	i n g r\ i: d i@ n t s
inhabited	i n h\ { b @ t @ d
inhabiting	i n h\ { b @ t i N
inheritance	i n h\ E r\ @ t @ n s
inhibitors	i n h\ i b @ t @ z
inhumane	i n h\ j u: m @i n
initial	i n i S @ l
initialisms	i n i S @ l @ z @ m z
initially	i n i S @ l i
initiative	i n i S @ t @ v
injection	i n d_0Z E k S @ n
injury	i n d_0Z @ r\ i
ink	i N k
inland	i n l { n d
inline	i n l ai n
inmates	i n m @i t s
inner	i n @ r\
innocent	i n @ s @ n t
innovation	i n @ v @i S @ n
inorganic	i n O: g { n i k
input	i n p U t
insanity	i n s { n @ t i
inspecting	i n s p E k t i N
inspiring	i n s p ai @ r\ i N
installation	i n s t @ l @i S @ n
instance	i n s t @ n s
instant	i n s t @ n t
instead	i n s t E d
insticuti	i n s t i k a t i
instinct	i n s t i N k t
institute	i n s t i t j u: t
institutes	i n s t i t j u: t s
institution	i n s t i t j u: S @ n
institutional	i n s t i t j u: S @ n @ l
institutions	i n s t i t j u: S @ n z
instruction	i n s t r\ a k S @ n
instrument	i n s t r\ U m @ n t
instruments	i n s t r\ U m @ n t s
insufficient	i n s @ f i S @ n t
insular	i n s j U l @ r\
insurance	i n S u@ r\ @ n s
intake	i n t @i k
integer	i n t @ d_0Z @ r\
integers	i n t @ d_0Z @ z
integral	i n t @ g r\ @ l
integrate	i n t i g r\ @i t
integrated	i n t i g r\ @i t @ d
integration	i n t i g r\ @i S @ n
integrity	i n t E g r\ @ t i
intellectual	i n t @ l E k tS u@ l
intelligence	i n t E l i d_0Z @ n s
intelligent	i n t E l i d_0Z @ n t
intelsat	i n t E l s { t
inter	i n t 3: r\
interaction	i n t @ r\ { k S @ n
interactive	i n t @ r\ { k t @ v
intercontinental	i n t @ k Q n t i n E n t @ l
interests	i n t r\ @ s t s
interface	i n t @ f @i s
interfaces	i n t @ f @i s @ s
interference	i n t @ f i@ r\ @ n s
interferences	i n t @ f i@ r\ @ n s @ s
interferencing	i n t @ f i@ r\ @ n s i N
interim	i n t @ r\ @ m
intermediate	i n t @ m i: d i@ t
internal	i n t 3: n @ l
international	i n t @ n { S @ n @ l
internationally	i n t @ n { S @ n @ l i
internet	i n t @ r\ n E t
interpretation	i n t 3: p r\ @ t @i S @ n
interpreters	i n t 3: p r\ @ t @ z
interpreting	i n t 3: p r\ @ t i N
interrogatories	i n t E r\ @ g @ t r\ i z
intersects	i n t @ s E k t s
interstate	i n t @ s t @i t
interuniversity	i n t @ r\ u: n i v 3: s @ t i
interval	i n t @ v @ l
interviewed	i n t @ v j u: d
into	i n t @
intravenous	i n t r\ @ v i: n @ s
intravenously	i n t r\ @ v i: n @ s l i
intrinsic	i n t r\ @ n s i k
introduced	i n t r\ @ d j u: s t
introducing	i n t r\ @ d j u: s i N
introductory	i n t r\ @ d a k t @ r\ i
intruding	i n t r\ u: d i N
intrusives	i n t r\ u: s @ v z
intuitive	i n t j u: @ t @ v
inuit	i n j u: @ t
invaded	i n v @i d @ d
invariance	i n v e@ r\ i@ n s
invariant	i n v e@ r\ i@ n t
invented	i n v E n t @ d
inventions	i n v E n S @ n z
inventors	i n v E n t @ z
inventory	i n v @ n t r\ i
inverse	i n v 3: s
investigation	i n v E s t i g @i S @ n
investigators	i n v E s t i g @i t @ z
investment	i n v E s t m @ n t
investments	i n v E s t m @ n t s
involve	i n v Q l v
involves	i n v Q l v z
involving	i n v Q l v i N
ioc	ai @u s i:
iodine	ai @u d i: n
ionia	ai @ n i@
ionian	ai @ n i@ n
ionic	ai Q n i k
ions	ai @ n z
iowa	ai @ w @
ip	ai p i:
ipa	ai p i: @i
ipcc	ai p i: s i: s i:
ipkf	ai p i: k @i E f
ips	ai p i: E s
ira	ai A: r\ @i
iran	i r\ A: n
iran	i r\ { n
iran's	i r\ A: n z
iran's	i r\ { n z
iranian	i r\ @i n i@ n
iraq	i r\ A: k
iraq	i r\ { k
iraq's	i r\ A: k s
iraq's	i r\ { k s
iraqi	i r\ A: k i
iraqi	i r\ { k i
ireland	ai @ l @ n d
irish	ai r\ i S
iron	ai @ n
ironic	ai r\ Q n i k
irritable	i r\ @ t @ b @ l
is	i z
isaac	ai z { k
isaac	ai z @ k
isaf	ai E s @i E f
isambard	ai s @ m b A: d
isentropic	ai s @ n t r\ Q p i k
islam	i z l A: m
islam	i z l { m
islami	i z l A: m i
islami	i z l { m i
islamic	i z l { m i k
island	ai l @ n d
islander	ai l @ n d @ r\
islands	ai l @ n d z
isle	ai l
ismaili	i z m @i l i
ismailis	i z m @i l @ s
iso	ai E s @u
iso	ai s @u
isolde	i s O: l d @
isomer	ai s @u m @ r\
isotopes	ai s @u t @u p s
isps	ai E s p i: E s
israel	i z r\ @i l
israeli	i z r\ @i l i
issue	i S u:
issued	i S u: d
issues	i S u: z
it	i t
italian	i t { l i@ n
italy	i t @ l i
itu	ai t i: j u:
iupac	ai j u: p i: @i s i:
ivan	ai v @ n
ivanovo	ai v @ n @u v @u
ivoire	ai v w A: r\
ivor	ai v @ r\
ivory	ai v @ r\ i
ivy	ai v i
jack	d_0Z { k
jackson	d_0Z { k s @ n
jacques	d_0Z A: k
jakarta	d_0Z @ k A: t @
jake	d_0Z @i k
jam	d_0Z { m
james	d_0Z @i m z
jamie	d_0Z @i m i
jan	d_0Z { n
janata	d_0Z @ n A: t @
jane	d_0Z @i n
january	d_0Z { n j U r\ i
japan	d_0Z @ p { n
japanese	d_0Z { p @ n i: z
jarred	d_0Z A: d
java	d_0Z A: v @
jay	d_0Z @i
jays	d_0Z @i z
jazz	d_0Z { z
jean	d_0Z i: n
jeff	d_0Z E f
jefferson	d_0Z E f 3: s @ n
jeffrey	d_0Z E f r\ i
jehova	d_0Z @ h\ @u v @
jeppes	d_0Z E p i
jeroboam	d_0Z E r\ @u b @u @ m
jerome	d_0Z @ r\ @u m
jerome's	d_0Z @ r\ @u m z
jerry	d_0Z E r\ i
jersey	d_0Z 3: z i
jerusalem	d_0Z E r\ u: s @ l E m
jervis	d_0Z @ v @ s
jesus	d_0Z i: z @ s
jet	d_0Z E t
jets	d_0Z E t s
jewish	d_0Z u: w i S
jews	d_0Z u: z
ji	d_0Z @i ai
jihad	d_0Z i h\ { d
jim	d_0Z @ m
jimbro	d_0Z i m b r\ @u
jimi	d_0Z i: m i
jimmy	d_0Z @ m i
jin	d_0Z @ n
jinnah	d_0Z i n a
jintao	d_0Z i n t au
jo'burg	d_0Z @u b 3: g
joachim	d_0Z @u A: k @ m
joash	d_0Z @u { S
job	d_0Z @u b
jobbik	d_0Z Q b i k
jobs	d_0Z @u b z
joburg	d_0Z @u b 3: g
joe	d_0Z @u
joey	d_0Z @u i
jogee	d_0Z @ d_0Z i
johanesburg	d_0Z @ h\ { n @ z b 3: g
johannesburg	d_0Z @ h\ { n @ z b 3: g
john	d_0Z Q n
johnny	d_0Z Q n i
johns	d_0Z Q n z
johnson	d_0Z Q n s @ n
joint	d_0Z Oi n t
joints	d_0Z Oi n t s
joke's	d_0Z @u k s
jolyon	d_0Z @u l i@ n
jon's	d_0Z Q n z
jonathan	d_0Z Q n @ T @ n
jones	d_0Z @u n z
jordan	d_0Z O: d @ n
jose	h\ @u z @i
josef	d_0Z @u z @ f
josef	j u@ s @ f
joseph	d_0Z @u z @ f
joshua	d_0Z Q S u@
josip	d_0Z @u s @ p
joslyn	d_0Z Q z l @ n
journal	d_0Z 3: n @ l
journalist	d_0Z 3: n @ l @ s t
journalists	d_0Z 3: n @ l @ s t s
journals	d_0Z 3: n @ l z
journey	d_0Z 3: n i
joy	d_0Z Oi
jpg	d_0Z @i p i: d_0Z i:
jr	d_0Z @i A: r\
juan	d_0Z A: n
judaism	d_0Z u: d @ z @ m
judge	d_0Z a d_0Z
judges	d_0Z a d_0Z @ z
judicial	d_0Z u: d i S @ l
judiciary	d_0Z u: d i S @ r\ i
judy	d_0Z u: d i
juice	d_0Z u: s
julesburg	d_0Z u: l z b 3: g
julian	d_0Z u: l i@ n
juliesburg	d_0Z u: l i z b 3: g
julius	d_0Z u: l i@ s
july	d_0Z u: l ai
junction	d_0Z a N k S @ n
june	d_0Z u: n
junichiro	d_0Z u: n i tS i r\ @u
junior	d_0Z u: n i@ r\
junius	d_0Z u: n i@ s
junk	d_0Z a N k
junod	d_0Z u: n @ d
jupiter	d_0Z u: p i t @ r\
jurassic	d_0Z u@ r\ @ s i k
juris	d_0Z u@ r\ @ z
jurisdiction	d_0Z u@ r\ @ s d i k S @ n
jurisdictions	d_0Z u@ r\ @ s d i k S @ n z
jury	d_0Z u@ r\ i
just	d_0Z a s t
justice	d_0Z a s t @ s
justices	d_0Z a s t @ s @ s
justified	d_0Z a s t @ f ai d
justus	d_0Z a s t @ s
juvenal	d_0Z u: v @ n @ l
k	k @i
kabaddi	k @ b A: d i
kaiser	k ai z @ r\
kalamak's	k { l @ m { k s
kalashnikov	k a l a S n i k Q f
kalenda	k @ l E n d @
kamakura	k { m @ k U r\ @
kammel	k { m @ l
kansas	k { n z @ s
kantian	k { n S i@ n
kappa	k a p a
karl	k A: l
karlsruhe	k A: l z r\ u@
kart	k A: r\ t
karzai	k A: z ai
kasparov's	k { s p @ r\ @ v z
kastler	k { s l @ r\
kate	k @i t
kaye's	k @i z
kcie	k @i s i: ai i:
keeling	k i: l i N
keeper	k i: p @ r\
kelheim	k E l h\ ai m
kelly	k E l i
kempton	k E m p t @ n
kemptonpark	k E m p t @ n p A: k
kenesaw	k E n s O:
kennedy	k E n @ d i
kennel	k E n @ l
kenneth	k E n @ T
kenny	k E n i
kensico	k E n s i k @u
kent	k E n t
kentucky	k E n t a k i
kenya	k E n j @
kept	k E p t
kerr	k E r\
kerry	k E r\ i
kevin	k E v @ n
key	k i:
keyboard	k i: b O: d
keyes	k i: z
keynes	k i: n z
keynesian	k i: n i: z i@ n
keys	k i: z
khali	k @ l i
khalid	k @ l @ d
khan	k A: n
khoisan	k Oi s { n
khural	k 3: r\ @ l
ki	k @i ai
kiddushin	k i d S @ n
kidney	k i d n i
kikki	k i k i
kilburn	k i l b 3: n
killed	k i l d
killer	k i l @ r\
kilometers	k i l Q m @ t @ z
kilometres	k i l Q m @ t @ z
kimberley	k i m b @ l i
kimberly	k i m b @ l i
kimchi	k i m tS i
kinetic	k i n E t i k
king	k i N
kingdom	k i N d @ m
kingdoms	k i N d @ m z
kingpin	k i N p @ n
kings	k i N z
kinhide	k i n h\ ai d
kinross	k i n r\ Q s
kippers	k i p @ z
kirsopp	k i r\ s @ p
kislovodsk	k i s l a v Q d s k
kit	k i t
kitesurfer	k ai t s 3: f @ r\
kitts	k i t s
klan	k l { n
klim's	k l @ m z
klux	k l a k s
knicks	n i k s
knight	n ai t
knights	n ai t s
knob	n Q b
know	n @u
knowingly	n @u i N l i
knowledge	n Q l i d_0Z
known	n @u n
ko	k @i @u
kofi	k Q f i
kofun	k Q f a n
kolmogorov	k Q l m Q g @ r\ Q f
kommen	k Q m @ n
komnenos	k Q m n E n @u s
kondratiev	k @ n d r\ @i t @ v
kondylis	k Q n d @ l s
kong	k Q N
konteradmiral	k Q n t @ r\ { d m @ r\ @ l
kool	k u: l
koppen	k Q p @ n
korea	k @ r\ i@
korea's	k @ r\ i@ z
korean	k @ r\ i@ n
korner's	k Q r\ n @ r\ z
kosovo	k Q s @ v @u
kp	k @i p i:
kricfalusi	k r\ i k f @ l U s i
kritika	k r\ i t i k @
ku	k u:
kuan	k w { n
kuiper	k @i p @ r\
kunc	k U N k
kush	k U S
kuwait	k U w @i t
kyi	k @i w ai ai
l	{ l
la	l A:
labels	l @i b @ l z
labor	l @i b @ r\
laboratories	l @ b Q r\ @ t r\ i z
laboratory	l @ b Q r\ @ t r\ i
labour	l @i b @ r\
lacking	l { k i N
lacks	l { k s
lacrosse	l @ k r\ Q s
lady	l @i d i
ladysmith	l @i d i s m @ T
laid	l @i d
lake	l @i k
lakers	l @i k @ z
lakes	l @i k s
lancaster	l { N k @ s t @ r\
land	l { n d
landforms	l { n d f O: m z
landing	l { n d i N
landis	l { n d @ z
landlocked	l { n d l Q k t
landmark	l { n d m A: k
landmarks	l { n d m A: k s
landscape	l { n d s k @i p
landscapes	l { n d s k @i p s
lane	l @i n
lang	l a N
lang	l { N
langton	l { N t @ n
language	l { N g w i d_0Z
languages	l { N g w i d_0Z @ z
lanka	l { N k @
lankan	l { N k @ n
lao	l au
laozi	l au z i
lap	l { p
laparoscopic	l { p @ r\ @ s k Q p i k
laplace	l @ p l { s
large	l A: d_0Z
largely	l A: d_0Z l i
larger	l A: d_0Z @ r\
largest	l A: d_0Z @ s t
larry	l { r\ i
lars	l A: z
larue	l A: r\ @
las	l @ z
last	l A: s t
lasted	l A: s t @ d
lasting	l A: s t i N
latch	l { tS
late	l @i t
later	l @i t @ r\
lateral	l { t @ r\ @ l
lateran	l { t @ r\ @ n
latin	l { t @ n
latitude	l { t i t j u: d
latvian	l { t v i@ n
launch	l O: n tS
launchers	l O: n tS @ z
laureate	l Q r\ i@ t
laureates	l Q r\ i@ t s
laureus	l Q r\ s
lavra	l { v r\ @
law	l O:
lawn	l O: n
lawrence	l Q r\ @ n s
laws	l O: z
lawsuit	l O: s u: t
lawsuits	l O: s u: t s
lawyers	l O: j @ z
layer	l @i @ r\
lazy	l @i z i
lds	{ l d i: E s
le	l @
lead	l E d
leader	l i: d @ r\
leaders	l i: d @ z
leadership	l i: d @ S @ p
leading	l E d i N
leads	l E d z
leaf	l i: f
leaflet	l i: f l @ t
leafs	l i: f s
league	l i: g
leagues	l i: g z
leamington	l i: m i N t @ n
leaning	l i: n i N
leap	l i: p
leaps	l i: p s
learned	l 3: n @ d
learning	l 3: n i N
least	l i: s t
leather	l E D @ r\
leave	l i: v
leaving	l i: v i N
lebanese	l E b @ n i: z
lebanon	l E b @ n @ n
lectures	l E k tS @ z
led	l E d
lee	l i:
lee's	l i: z
left	l E f t
leftist	l E f t @ s t
lefty	l E f t i
leg	l E g
legal	l i: g @ l
legend	l E d_0Z @ n d
legendary	l E d_0Z @ n d r\ i
legends	l E d_0Z @ n d z
legion	l i: d_0Z @ n
legislation	l E d_0Z i s l @i S @ n
legislative	l E d_0Z @ s l @ t @ v
legislature	l E d_0Z i s l @i tS @ r\
legitimate	l i d_0Z @ t @ m @ t
lego	l E g @u
leibniz	l ai b n @ t s
leiden	l ai d @ n
lemnos	l E m n @u z
length	l E N T
lenin	l E n @ n
lennon's	l E n @ n z
leo	l i @u
leon	l i Q n
leondale	l i@ n d @i l
leone	l i @u n
leopold	l i @u p @u l d
leopoldina	l i @u p Q l d i: n @
les	l E z
lesbian	l E z b i@ n
lesbians	l E z b i@ n z
lesser	l E s @ r\
lethal	l i: T @ l
letter	l E t @ r\
letterman's	l E t @ m @ n z
letters	l E t @ z
lettres	l E t @ z
levant	l i v { n t
level	l E v @ l
levels	l E v @ l z
levy	l E v i
lewes's	l u: @ s @ z
lewis	l u: @ s
lewisham	l u: i S @ m
lexical	l E k s i k @ l
leytonstone	l @i t @ n s t @ n
lgbt	{ l d_0Z i: b i: t i:
lgt	{ l d_0Z i: t i:
liability	l ai @ b @ l @ t i
liamuiga	l i@ m i: g @
liberal	l @ b @ r\ @ l
liberalize	l @ b r\ @ l ai z
liberating	l @ b @ r\ @i t i N
liberation	l @ b @ r\ @i S @ n
liberian	l @i b i@ r\ i@ n
libertarianism	l @ b @ t e@ r\ i@ n @ z @ m
liberties	l i b @ t i z
liberty	l i b @ t i
librarian	l ai b r\ e@ r\ i@ n
library	l ai b r\ @ r\ i
librorum	l i b r\ O: r\ @ m
libya	l @ b i@
license	l ai s @ n s
licenses	l ai s @ n s @ s
licks	l i k s
liddell	l @ d @ l
lie	l ai
lieberman	l i b @ r\ m @ n
liebig	l i b i g
lieutenancy	l E f t E n @ n s i
life	l ai f
life's	l ai f s
lifeforms	l ai f f O: m z
lifetime	l ai f t ai m
light	l ai t
lighter	l ai t @ r\
lighting	l ai t i N
lightweight	l ai t w @i t
like	l ai k
liked	l ai k t
lille	l @ l
lilly	l i l i
limestone	l ai m s t @u n
limit	l @ m @ t
limited	l @ m @ t @ d
limitless	l @ m @ t l @ s
limits	l @ m @ t s
linares	l @ n e@ z
lincoln	l i N k @ n
lincoln's	l i N k @ n z
lindley	l @ n d l i
line	l ai n
linear	l i n i@ r\
lines	l ai n z
linguistics	l i N g w i s t i k s
linguists	l i N g w @ s t s
link	l i N k
linkage	l i N k i d_0Z
linked	l i N k t
links	l i N k s
linux	l @ n j k s
lions	l ai @ n z
lios	l ai @ s
liquefied	l i k w @ f ai d
liquid	l i k w @ d
lisbalting	l @ z b O: l t i N
lisbon	l @ z b @ n
lisbon's	l @ z b @ n z
lisp	l @ s p
lissamphibia	l @ s { m f i b i@
list	l @ s t
listed	l @ s t @ d
lists	l i: s t s
literacy	l @ t @ r\ @ s i
literary	l @ t @ r\ @ r\ i
literature	l @ t r\ @ tS @ r\
lithography	l i T Q g r\ @ f i
lithuania	l @ T U @i n i@
lithuanian	l @ T U @i n i@ n
little	l @ t l @
liturgical	l i t 3: d_0Z i k @ l
live	l ai v
lived	l @ v d
liver	l @ v @ r\
livermore	l @ v @ m O: r\
liverpool	l @ v @ p u: l
living	l i v i N
lizzy	l @ z i
lloyd	l Oi d
lm	{ l E m
lng	{ l E n d_0Z i:
loaf	l @u f
loanwords	l @u n w 3: d z
local	l @u k @ l
located	l @u k @i t @ d
location	l @u k @i S @ n
locations	l @u k @i S @ n z
loch	l Q k
lock	l Q k
locomotion	l @u k @ m @u S @ n
lofty	l Q f t i
logan	l @u g @ n
logarithm	l Q g @ r\ @ D @ m
logg	l Q g
logging	l Q g i N
logic	l Q d_0Z i k
logicians	l @ d_0Z i S @ n z
logo	l @ g @u
loki	l @ k i
lombard	l Q m b A: d
london	l a n d @ n
london's	l a n d @ n z
lonely	l @u n l i
long	l Q N
longdale	l Q N d @i l
longest	l Q N g @ s t
longfellow	l Q N f E l @u
longley	l Q N l i
lookalike	l U k @ l ai k
looked	l U k t
looking	l U k i N
loop	l u: p
looping	l u: p i N
loosely	l u: s l i
looting	l u: t i N
lopez	l @u p E z
lord	l O: d
lorentz	l O: r\ E n t s
los	l @u z
losing	l u: z i N
losses	l Q s @ s
lossless	l Q s l @ s
lossy	l Q s i
lost	l Q s t
lothian	l @u D i@ n
lou	l u:
loud	l au d
lough	l Q k
louis	l u: i
louisiana	l u: i z i { n @
love	l a v
lovecraft	l a v k r\ A: f t
low	l @u
lowballed	l @u b { l d
lower	l au @ r\
lowest	l @u @ s t
loyalists	l Oi @ l @ s t s
loyalty	l Oi @ l t i
lpg	{ l p i: d_0Z i:
lrp	{ l A: r\ p i:
lsd	{ l E s d i:
lubitsch	l j u: b @ tS
lucas	l u: k @ s
lucius	l u: s i@ s
lucky	l a k i
luis	l @u @ s
luke	l u: k
lunar	l u: n @ r\
lung	l a N
lust	l a s t
luther	l U T @ r\
lutheran	l u: T @ r\ @ n
lutherans	l u: T @ r\ @ n z
lydenburg	l ai d @ n b 3: g
lydia	l i d i@
lynch's	l i n S @ z
lyndon	l @ n d @ n
lynx	l i N k s
lyon	l i: O: n
lyons	l i: O: n z
lyric	l @ r\ i k
m	E m
ma	m A:
mac	m { k
macarthur	m { k A: T @ r\
macau	m @ k O:
macedon	m { s i d @ n
macedonian	m { s i d @u n i@ n
machina	m @ S i: n a
machine	m @ S i: n
machines	m @ S i: n z
machinima	m @ S i n i: m @
mackenzie	m @ k E n z i
maclaurin	m @ k l O: r\ @ n
macnaughton	m @ k n O: t @ n
macon	m { k @ n
mactare	m { k t e@ r\
madison	m { d @ s @ n
maestro	m ai s t r\ @u
mafalda's	m @ f { l d @i z
mafra	m @ f r\ @
magazine	m { g @ z i: n
magdeburg	m { g d @ b 3: g
maggiore	m { d_0Z i: O: r\
magna	m { g n @
magnetic	m { g n E t i k
magnetized	m { g n @ t ai z d
mah	m A:
mahanadi	m a h\ a n A: d i
maharaja	m a h\ a r\ A: d_0Z a
maid	m @i d
maida	m ai d @
mail	m @i l
mailboxes	m @i l b Q k s @ s
maildir	m @i l d @ r\
mailed	m @i l d
main	m @i n
maine	m @i n
mainstay	m @i n s t @i
mainstream	m @i n s t r\ i: m
maintain	m @i n t @i n
maintained	m @i n t @i n d
maintains	m @i n t @i n z
mainz	m @i n z
maison	m @i z @ n
majesties	m { d_0Z @ s t i z
major	m @i d_0Z @ r\
majorities	m @ d_0Z Q r\ @ t i z
majority	m @ d_0Z Q r\ @ t i
make	m @i k
makers	m @i k @ z
makes	m @i k s
making	m @i k i N
male	m @i l
maler	m A: l @ r\
malik	m { l i k
malory	m { l @ r\ i
malta	m a l t @
malvernians	m a l v @ n i@ n z
mammal	m { m @ l
mammals	m { m @ l z
man	m { n
man's	m { n z
manage	m { n i d_0Z
management	m { n i d_0Z m @ n t
manager	m { n i d_0Z @ r\
managing	m { n i d_0Z i N
manchester	m { n tS @ s t @ r\
mancunians	m { n k j u: n i@ n z
mandarin	m { n d @ r\ @ n
mandatory	m { n d @ t r\ i
manfred	m { n f r\ @ d
manga	m { N g @
manganese	m { N g @ n i: z
mangroves	m { N g r\ @u v z
manhattan	m { n h\ { t @ n
manifold	m { n i f @u l d
manifolds	m { n i f @u l d z
manipulating	m @ n i p j U l @i t i N
manitoba	m { n i t @u b @
manmohan	m @ n m @u h\ { n
mann	m { n
manned	m { n d
mannheim	m { n h\ ai m
mans	m { n z
manufacturer	m { n j U f { k tS @ r\ @ r\
manufacturers	m { n j U f { k tS @ r\ @ z
manufacturing	m { n j U f { k tS @ r\ i N
manuscript	m { n j U s k r\ @ p t
manuscripts	m { n j U s k r\ @ p t s
many	m E n i
map	m { p
maple	m @i p @ l
mapping	m { p i N
maradona	m { r\ @ d Q n @
marangella's	m { r\ @ n d_0Z { l @ z
marble	m A: b @ l
marcel	m A: s E l
marcellus	m A: s E l @ s
march	m A: tS
marcus	m A: k @ s
margaret	m A: g r\ @ t
marginal	m A: d_0Z @ n @ l
margins	m A: d_0Z @ n z
margraves	m A: g r\ @i v z
maria	m @ r\ i@
mariana	m { r\ i { n @
marine	m @ r\ i: n
marines	m @ r\ i: n z
marinese	m @ r\ @ n i: z
mario	m { r\ i @u
mariology	m { r\ i Q l @ d_0Z i
maritime	m { r\ @ t ai m
mark	m A: k
marker	m A: k @ r\
market	m A: k @ t
marketed	m A: k @ t @ d
markets	m A: k @ t s
marking	m A: k i N
marksmen	m A: k s m @ n
marple	m A: p @ l
marriage	m { r\ i d_0Z
married	m { r\ i d
mars	m A: z
marsh	m A: S
marshall	m A: S @ l
martial	m A: S @ l
martin	m A: t @ n
martingale	m A: t i N g @i l
martyr	m A: t @ r\
marvel	m A: v @ l
marvin	m A: v @ n
marx	m A: r\ k s
marxist	m A: k s @ s t
mary	m e@ r\ i
mary's	m e@ r\ i z
masculine	m { s k j U l @ n
masked	m A: s k t
mason	m @i s @ n
masonry	m @i s @ n r\ i
mass	m { s
massachusetts	m { s @ tS u: s @ t s
massacre	m { s @ k @ r\
masse	m { s
massively	m { s @ v l i
massoud	m a s au d
massoud's	m a s au d z
master	m A: s t @ r\
masters	m A: s t @ z
masterson's	m A: s t @ s @ n z
match	m { tS
matching	m { tS i N
mateo	m { t @i @u
material	m @ t i@ r\ i@ l
materials	m @ t i@ r\ i@ l z
mathematica	m { T @ m { t i k @
mathematical	m { T @ m { t i k @ l
mathematician	m { T @ m @ t i S @ n
mathematicians	m { T @ m @ t i S @ n z
mathematics	m { T @ m { t i k s
mathews	m { T j u: z
matilda	m @ t @ l d @
matrix	m @i t r\ i k s
matter	m { t @ r\
matters	m { t @ z
maturity	m @ t j u@ r\ @ t i
maurier's	m Q r\ i@ r\ z
mauritania	m Q r\ @ t @i n i@
mauryan	m O: r\ ai @ n
mauzer	m au z @ r\
max	m { k s
maxima	m { k s @ m @
maximum	m { k s @ m @ m
maxwell	m { k s w @ l
may	m @i
maya	m ai j @
mayflower	m @i f l au @ r\
maynard	m @i n A: d
mayo	m @i j @u
mayor	m e@ r\
mayors	m e@ z
mccain	m k @i n
mccarran	m @ k { r\ @ n
mccarthy	m @ k A: T i
mccausland	m @ k O: s l @ n d
mcclennan's	m @ k l E n @ n s
mcclernand's	m @ k l 3: n @ n d s
mclean	m @ k l i: n
mcphail	m @ k f ai l
me	m i:
meal	m i: l
mean	m i: n
meaning	m i: n i N
meaningful	m i: n i N f @ l
meant	m E n t
measure	m E Z @ r\
measured	m E Z @ d
measurement	m E Z @ m @ n t
measurements	m E Z @ m @ n t s
meat	m i: t
mechanical	m i k { n i k @ l
mechanics	m i k { n i k s
mechanism	m E k @ n @ z @ m
mechanized	m E k @ n ai z d
medal	m E d @ l
medalists	m E d @ l @ s t s
medals	m E d @ l z
media	m i: d i@
median	m i: d i@ n
mediated	m i: d i @i t @ d
mediation	m i: d i @i S @ n
medical	m E d i k @ l
medications	m E d i k @i S @ n z
medicine	m E d s @ n
medicines	m E d s @ n z
medieval	m E d i: v @ l
meditation	m E d @ t @i S @ n
mediterranean	m E d @ t @ r\ @i n i@ n
medium	m i: d i@ m
meeting	m i: t i N
mega	m E g @
megafauna	m E g @ f O: n @
mei	m @i
meijer	m @i j @ r\
melbourne	m E l b O: n
mellon	m E l @ n
melodifestivalen	m @ l @u d @ f E s t @ v @ l @ n
melt	m E l t
melting	m E l t i N
meltwater	m E l t w O: t @ r\
member	m E m b @ r\
members	m E m b @ z
membership	m E m b @ S @ p
membrane	m E m b r\ @i n
memorial	m i m O: r\ i@ l
memorial	m @ m O: r\ i@ l
memories	m E m @ r\ i z
memory	m E m @ r\ i
memphis	m E m f @ s
men	m E n
mend	m E n d
mendoza	m E n d @u z a
menelik	m E n @ l i k
menke	m E N k
mental	m E n t @ l
mentioned	m E n S @ n d
mentioning	m E n S @ n i N
merah	m E r\ @
mercantile	m 3: k @ n t ai l
merchant	m 3: tS @ n t
merchants	m 3: tS @ n t s
mercury	m 3: k j U r\ i
mercury's	m 3: k j U r\ i z
mercy	m 3: s i
merdeka	m @ r\ d E k @
meredith	m E r\ @ d @ T
merges	m 3: d_0Z @ z
merit	m E r\ @ t
mesolithic	m i: s @u l @ T i k
message	m E s i d_0Z
messages	m E s i d_0Z @ z
messaging	m E s i d_0Z i N
messiah	m @ s ai @
messina	m @ s i: n @
met	m E t
metabolic	m E t @ b Q l i k
metabolism	m E t @ b @ l @ z @ m
metadata	m E t @ d @i t @
metal	m E t @ l
metals	m E t @ l z
metamorphoses	m E t @ m O: f @u s i s
metaphors	m E t @ f @ z
metaphysics	m E t @ f i z i k s
meteorological	m i: t j @ r\ @ l Q d_0Z i k @ l
meters	m i: t @ z
method	m E T @ d
methodist	m E T @ d @ s t
methods	m E T @ d z
metic	m E t i k
metics	m E t i k s
metric	m E t r\ i k
metro	m E t r\ @u
metropolitan	m E t r\ @ p Q l @ t @ n
mets	m E t s
mexican	m E k s i k @ n
mexico	m E k s i k @u
meyer	m @i j @ r\
meyerton	m @i j @ t @ n
mi	m i:
michael	m ai k @ l
michel	m ai k @ l
michel	m i S E l
michiel	m i S E l
michigan	m i S i g @ n
mick	m i k
mickey	m i k i
micro	m ai k r\ @u
microcomputers	m ai k r\ @u k @ m p j u: t @ z
micrometre	m ai k r\ @u m i: t @ r\
microprocessor	m ai k r\ @u p r\ @u s E s @ r\
microscope	m ai k r\ @ s k @u p
microscopically	m ai k r\ @ s k Q p i k l i
microscopy	m ai k r\ Q s k @ p i
microsoft	m ai k r\ @u s Q f t
microwave	m ai k r\ @u w @i v
mid	m @ d
middelburg	m @ d @ l b 3: g
middle	m @ d @ l
middleburg	m @ d @ l b 3: g
midi	m i d i
midrand	m @ d r\ { n d
midwestern	m i d w E s t @ n
mies	m i: z
might	m ai t
migration	m ai g r\ @i S @ n
mike	m ai k
mikhail	m i: k ai l
mild	m ai l d
mildly	m ai l d l i
miles	m ai l z
milesians	m ai l i: z i@ n z
militant	m @ l @ t @ n t
militar	m @ l @ t A: r\
military	m i l i t r\ i
milk	m @ l k
milko	m @ l k @u
milkstone	m @ l k s t @u n
milky	m @ l k i
millennium	m i l E n i@ m
miller's	m @ l @ z
million	m i l i@ n
milo	m ai l @u
milton	m @ l t @ n
milwaukee	m @ l w O: k i
mind	m ai n d
mine	m ai n
mineral	m @ n @ r\ @ l
minerals	m @ n @ r\ @ l z
miners	m ai n @ z
minerva	m ai n 3: v @
mingus	m i N g @ s
minh	m @ n
mini	m i n i
minimal	m @ n @ m @ l
minimalism	m @ n @ m @ l @ z @ m
minimum	m @ n @ m @ m
mining	m ai n i N
minister	m @ n @ s t @ r\
ministers	m @ n @ s t @ z
minnesota	m @ n @ s @u t @
minoan	m ai n @u n
minor	m ai n @ r\
minority	m ai n Q r\ @ t i
mints	m @ n t s
minute	m ai n j u: t
miracles	m @ r\ @ k @ l z
mirandola	m i r\ { n d @u l a
mirchi	m 3: tS i
misadventure	m @ s @ d v E n tS @ r\
misandry	m @ s { n d r\ i
miss	m @ s
missile	m i s ai l
missiles	m i s ai l z
missing	m i s i N
mission	m i S @ n
missionaries	m i S @ n r\ i z
missionary	m i S @ n r\ i
missions	m i S @ n z
mississippi	m @ s @ s @ p i
missouri	m @ z u@ r\ i
mistake	m i s t @i k
mister	m @ s t @ r\
mitford	m i t f @ d
mitford's	m @ t f @ d s
mitochondrial	m i t @u k Q n d r\ i@ l
mits	m @ t s
mitterrand	m i: t @ r\ A:
mixage	m i k s i d_0Z
mixed	m i k s t
mixing	m i k s i N
mixtures	m i k s tS @ z
ml	E m E l
ml	m @ l i l i: t @
mmu	E m E m j u:
mobile	m @u b ai l
mobility	m @u b @ l @ t i
mockup	m Q k a p
mod	m Q d
mode	m @u d
model	m Q d @ l
model's	m Q d @ l z
modeling	m Q d l i N
models	m Q d @ l s
models	m Q d @ l z
moderately	m Q d @ r\ @ t l i
modern	m Q d @ n
modernisme	m Q d @ n @ z m
modes	m @u d z
modifications	m Q d i f i k @i S @ n z
modified	m Q d @ f ai d
modulation	m Q d j U l @i S @ n
module	m Q d j u: l
moe	m @u
mohammad	m @ h\ { m @ d
mohammed	m @ h\ { m @ d
moines	m Oi n
molecular	m @ l E k j U l @ r\
molecules	m Q l @ k j u: l z
molluscs	m Q l @ s k s
molotov	m Q l @ t Q f
moment	m @u m @ n t
momentum	m @ m E n t @ m
monaco	m Q n @ k @u
monarchies	m Q n @ k i z
monarchists	m Q n @ k @ s t s
monarchs	m Q n @ k s
monarchy	m Q n @ k i
monasteries	m Q n @ s t r\ i z
monastic	m @ n { s t i k
monday	m a n d @i
mondeor	m Q n d i O: r\
monetary	m a n i t r\ i
monitor	m Q n @ t @ r\
monkeys	m a N k i z
monks	m a N k s
monoamine	m @u n @u { m i: n
monopoly	m @ n Q p @ l i
monotypic	m Q n @ t @ p i k
monoxide	m Q n Q k s ai d
monroe	m Q n r\ @u
monster	m Q n s t @ r\
mont	m Q n t
montclair	m Q n t k l e@ r\
montfree	m Q n t f r\ i:
month	m a n T
months	m a n T s
montmartre	m Q m A: t r\ @i
montmartre	m Q m A: tS
monty	m Q n t i
monument	m Q n j U m @ n t
monumental	m Q n j U m E n t @ l
moon	m u: n
moon's	m u: n z
moorish	m u@ r\ i S
mord	m O: d
more	m O: r\
morgan	m O: g @ n
morgenzon	m Q r\ g @ n z @ n
morning	m O: n i N
morocco	m @ r\ Q k @u
morrison	m Q r\ @ s @ n
mortal	m O: t @ l
mortality	m O: t { l @ t i
morte	m O: t
mortgage	m O: g i d_0Z
mosaic	m @u z @i i k
moscow	m Q s k @u
motherwell	m a D @ w E l
motifs	m @u t i: f s
motile	m @u t ai l
motion	m @u S @ n
motor	m @u t @ r\
motorola	m @u t @ r\ @u l @
mount	m au n t
mountain	m au n t @ n
mountains	m au n t @ n z
mounted	m au n t @ d
mourner	m O: n @ r\
mouse	m au s
mouseball	m au s b O: l
movable	m u: v @ b @ l
moved	m u: v d
movement	m u: v m @ n t
movements	m u: v m @ n t s
mover	m u: v @ r\
movie	m u: v i
movies	m u: v i z
moving	m u: v i N
mozambique	m @u z { m b i: k
mri	E m A: r\ ai
msc	E m E s s i:
msd	E m E s d i:
mt	E m t i:
mtv	E m t i: v i:
mu	m u:
mudd	m a d
muds	m a d z
muhammad	m @ h\ { m @ d
muller	m @ l @ r\
mulroney	m a l r\ @u n i
multi	m a l t i
multicellular	m a l t i s E l j U l @ r\
multidirectional	m a l t i d ai r\ E k S @ n @ l
multinational	m a l t i n { S @ n @ l
multiplayer	m a l t i p l @i @ r\
multiple	m a l t @ p @ l
multiplicativity	m a l t i p l i k @ t @ v @ t i
multiplier	m a l t i p l ai @ r\
multipurpose	m a l t i p 3: p @ s
mundane	m a n d @i n
munich	m j u: n i k
municipal	m j u: n @ s @ p @ l
municipalities	m j u: n i s i p { l @ t i z
municipality	m j u: n i s i p { l @ t i
murder	m 3: d @ r\
murdered	m 3: d @ d
murdoch's	m 3: d Q k s
murray	m a r\ i
museum	m j u: z i@ m
museums	m j u: z i@ m z
musharraf	m U S a r\ a f
music	m j u: z i k
musical	m j u: z i k @ l
musicals	m j u: z i k @ l z
musicians	m j u: z i S @ n z
muslim	m U z l @ m
muslims	m U z l @ m z
mussolini	m U s @ l i: n i
mussolini's	m U s @ l i: n i z
musth	m a s T
mutant	m j u: t @ n t
mutants	m j u: t @ n t s
mutations	m j u: t @i S @ n z
mutilation	m j u: t @ l @i S @ n
mutual	m j u: tS u@ l
mvp	E m v i: p i:
my	m ai
mycenae	m ai s i: n ai
myocardial	m ai k A: d i@ l
myrmecophagous	m 3: m i k Q f @ g @ s
myrmidons	m 3: m i d @ n z
mystery	m @ s t @ r\ i
mystics	m @ s t i k s
mythological	m @ T @ l Q d_0Z i k @ l
mythology	m @ T Q l @ d_0Z i
mytileneans	m @ t @ l i: n i@ n z
n	E n
na	E n @i
nacional	n { S i@ n @ l
nafta	n a f t @
nairobi	n ai r\ @u b i
naive	n ai i: v
name	n @i m
named	n @i m d
names	n @i m z
naming	n @i m i N
nanded	n { n d @ d
nandhi	n { n d i
nansen	n { n s @ n
naples	n @i p @ l s
napoleon	n @ p @u l i@ n
napoleon's	n @ p @u l i@ n z
narayan	n { r\ @ j @ n
narcotics	n A: k Q t i k s
narrative	n { r\ @ t @ v
narrators	n @ r\ @i t @ z
narrow	n { r\ @u
nasa	n A: s a
nasa's	n A: s a z
nashville	n { S v @ l
natal	n @i t @ l
natal	n @ t E l
natalia	n { t @i l i@
national	n { S @ n @ l
nationalism	n { S @ n @ l @ z @ m
nationalists	n { S @ n @ l @ s t s
nationality	n { S @ n { l @ t i
nations	n @i S @ n z
native	n @i t @ v
nato	n @i t @u
natural	n { tS r\ @ l
naturalis	n { tS @ r\ A: l @ s
naturalists	n { tS @ r\ @ l @ s t s
naturalized	n { tS @ r\ @ l ai z d
naturally	n { tS @ r\ @ l i
naturally	n { tS r\ @ l i
nature	n @i tS @ r\
naturist	n { tS @ r\ @ s t
nautical	n O: t i k @ l
naval	n @i v @ l
navies	n @i v i z
navigable	n { v i g @ b @ l
navigation	n { v i g @i S @ n
navigatium	n { v i g @i t i@ m
navy	n @i v i
nazi	n A: t s i
nb	E n b i:
nba	E n b i: @i
nbc	E n b i: s i:
ncaa	E n s i: @i @i
neapolitan	n i@ p Q l @ t @ n
near	n i@ r\
nearby	n i@ b ai
nearly	n i@ l i
nebraska	n @ b r\ { s k @
nebula	n E b j U l @
necessarily	n E s @ s E r\ @ l i
necessity	n i s E s @ t i
neck	n E k
necker	n E k @ r\
need	n i: d
needed	n i: d @ d
needs	n i: d z
negative	n E g @ t @ v
negatively	n E g @ t @ v l i
negotiations	n i g @u S i @i S @ n z
neighbor	n @i b @ r\
neighbors	n @i b @ z
neighbours	n @i b @ z
neil	n i@ l
nelly	n E l i
neo	n i @u
neoclassical	n i @u k l { s i k @ l
neoliberal	n i @u l @ b @ r\ @ l
neologisms	n i Q l @ d_0Z @ z @ m z
neon	n i Q n
nepali	n @ p A: l i
nepheline	n E f @ l i: n
nephritis	n E f r\ ai t @ s
nero	n @ r\ @u
ness	n E s
net	n E t
netherlands	n E D @ l @ n d z
netscape	n E s k @i p
network	n E t w 3: k
networking	n E t w 3: k i N
networks	n E t w 3: k s
neumann	n j u: m @ n
neural	n j u@ r\ @ l
neurologic	n j u@ r\ @ l Q d_0Z i k
neurological	n j u@ r\ @ l Q d_0Z i k @ l
neurologists	n j u@ r\ Q l @ d_0Z @ s t s
neuropathies	n j u@ r\ Q p @ T i z
neuroscientists	n j u@ r\ @u s ai @ n t @ s t s
neutral	n j u: t r\ @ l
neutron	n j u: t r\ Q n
nevada	n @ v A: d @
never	n E v @ r\
neville	n E v @ l
nevis	n E v @ s
nevsky	n E v s k i
new	n j u:
newark	n j u: w @ k
newcastle	n j u: k { s @ l
newington	n j u: i N t @ n
newly	n j u: l i
news	n j u: z
newspaper	n j u: s p @i p @ r\
newspapers	n j u: s p @i p @ z
newsprint	n j u: z p r\ @ n t
newton	n j u: t @ n
nfc	E n E f s i:
nfl	E n E f { l
ngos	E n d_0Z i: @u z
nh	E n @i tS
nhl	E n @i tS { l
nicene	n ai s i: n
nicholas	n i k @ l @ s
nicholls	n i k Q l z
nicolas	n i k @ l @ z
niels	n i@ l z
nietzsche	n i t S @
nigel	n ai d_0Z @ l
niger	n ai d_0Z @ r\
nigerian	n ai d_0Z i@ r\ i@ n
nigerien	n ai d_0Z i@ r\ i@ n
night	n ai t
nightly	n ai t l i
nihongo	n i h\ Q N g @u
nine	n ai n
nineteenth	n ai n t i: n T
ninja	n i n d_0Z @
nintendo	n ai n t E n d @u
ninth	n ai n T
nitric	n ai t r\ i k
nitrogen	n ai t r\ @ d_0Z @ n
nixon	n i k s @ n
nmda	E n E m d i: @i
no	n @u
noah	n @u @
nobel	n @u b E l
noble	n @u b @ l
nobleness	n @u b @ l n @ s
noisy	n Oi z i
nokia	n @ k i@
nolink	n @ l i N k
nomadic	n @u m { d i k
nominal	n Q m @ n @ l
nominally	n Q m @ n @ l i
nominated	n Q m @ n @i t @ d
nomination	n Q m @ n @i S @ n
nominations	n Q m @ n @i S @ n z
nominees	n Q m i n i: z
non	n Q n
nondeterministic	n Q n d i t 3: m @ n @ s t i k
nongovernmental	n Q N g a v @ m E n t @ l
nonlinear	n Q n l @ n i@ r\
nonsignatory	n Q n s i g n @ t r\ i
nonverbal	n Q n v @ r\ b @ l
nordic	n O: d i k
norm	n O: m
normal	n O: m @ l
normally	n O: m @ l i
norman	n O: m @ n
normed	n O: m d
noro	n Q r\ @u
norris	n Q r\ @ s
norse	n O: s
north	n O: T
northeast	n O: T i: s t
northeastern	n O: T i: s t @ n
northern	n O: D @ n
northwest	n O: T w E s t
norwegian	n O: w i: d_0Z @ n
norwich	n Q r\ i tS
not	n Q t
notable	n @u t @ b @ l
notably	n @u t @ b l i
notaries	n @u t @ r\ i z
notation	n @u t @i S @ n
note	n @u t
notorious	n @u t O: r\ i@ s
noun	n au n
nouveau	n @ v @u
nova	n @u v @
novel	n Q v @ l
novelists	n Q v @ l @ s t s
novella	n @u v E l a
novello	n @u v E l @u
novels	n Q v @ l s
november	n @u v E m b @ r\
now	n au
nowrap	n @u r\ { p
ns	E n E s
nsa	E n E s @i
nsk	E n E s k @i
nuclear	n j u: k l i@ r\
nucleic	n j u: k l @i i k
nucleosynthesis	n j u: k l i@ s @ n T @ s @ s
nuclide	n j u: k l i d
null	n a l
number	n a m b @ r\
numbering	n a m b @ r\ i N
numbers	n a m b @ z
numeric	n j u: m E r\ i k
numerous	n j u: m @ r\ @ s
nuncios	n a n s i@ U z
nuns	n a n z
nurses	n 3: s @ s
nuts	n a t s
nuttie	n a t i
nwabudike	n w a b U d i: k
o	@u
oakland	@u k l @ n d
oas	@u @i E s
oath	@u T
oau	@u @i j u:
obama	@u b a m a
obama	@u b { m @
obama's	@u b a m a z
obama's	@u b { m @ z
obfuscated	Q b f @ s k @i t @ d
object	Q b d_0Z @ k t
objects	Q b d_0Z @ k t s
oblast	@ b l { s t
observances	@ b s 3: v @ n s @ s
observation	Q b s @ v @i S @ n
observation	Q b z @ v @i S @ n
observations	Q b s @ v @i S @ n z
observations	Q b z @ v @i S @ n z
observatory	@ b s 3: v @ t r\ i
observatory	@ b z 3: v @ t r\ i
observed	@ b z 3: v d
observers	@ b z 3: v @ z
obsessive	@ b s E s @ v
obsolescent	Q b s @ l E s @ n t
obsolete	Q b s @ l i: t
obtain	@ b t @i n
obvious	Q b v i@ s
occasionally	@ k @i Z @ n @ l i
occult	Q k a l t
occupation	Q k j U p @i S @ n
occupational	Q k j U p @i S @ n @ l
occupations	Q k j U p @i S @ n z
occupied	Q k j U p ai d
occurring	@ k 3: r\ i N
occurs	@ k 3: z
ocean	@u S @ n
oceanic	@u S i { n i k
october	Q k t @u b @ r\
odd	Q d
odense	@u d E n s
odowska	@u d @u s k a
odyssey	Q d i s i
oecs	@u i: s i: E s
of	Q v
offense	@ f E n s
offered	Q f @ d
offering	Q f @ r\ i N
offers	Q f @ z
office	Q f @ s
officer	Q f @ s @ r\
officers	Q f @ s @ z
offices	Q f @ s @ s
official	@ f i S @ l
officially	@ f i S @ l i
officials	@ f i S @ l z
offshore	Q f S O: r\
offspring	Q f s p r\ i N
ohio	@u h\ ai @u
oil	Oi l
oklahoma	@u k l @ h\ @u m @
okrug	@u k r\ a g
old	@u l d
older	@u l d @ r\
oldest	@u l d @ s t
oliver	Q l @ v @ r\
olympiad	@ l @ m p i { d
olympians	@ l @ m p i@ n z
olympic	@ l @ m p i k
olympiodoros	@ l @ m p i @u d @ r\ @u s
oman	@u m a n
on	Q n
onboard	Q n b O: d
ones	w a n z
oneword	w a w 3: d
online	Q n l ai n
only	@u n l i
ono	Q n @u
onomatopoeic	Q n @ m a t @ p i@ k
ontario	Q n t e@ r\ i @u
opec	@u p E k
opec	@u p i: i: s i:
opel	@u p @ l
open	@u p @ n
openid	@u p @ n @ d
opera	Q p @ r\ @
operas	Q p r\ @ z
operate	Q p @ r\ @i t
operates	Q p @ r\ @i t s
operating	Q p @ r\ @i t i N
operation	Q p @ r\ @i S @ n
operational	Q p @ r\ @i S @ n @ l
operations	Q p @ r\ @i S @ n z
operators	Q p @ r\ @i t @ z
opium	@u p i@ m
opportunity	Q p @ t j u: n @ t i
opposes	@ p @u z @ z
opposition	Q p @ z i S @ n
optic	Q p t i k
optical	Q p t i k @ l
optics	Q p t i k s
option	Q p S @ n
options	Q p S @ n z
or	O: r\
oracular	@ r\ { k j U l @ r\
oral	O: r\ @ l
orally	O: r\ @ l i
orange	Q r\ i n d_0Z
orbit	O: b @ t
orbital	O: b @ t @ l
orbits	O: b @ t s
orchestra	O: k @ s t r\ @
order	O: d @ r\
ordered	O: d @ d
orders	O: d @ z
ordinance	O: d @ n @ n s
ordinary	O: d @ n r\ i
ordnance	O: d n @ n s
ordo	O: d @u
ordovician	O: d @ v i S i@ n
ordre	O: d r\ @i
ore	O: r\
oregon	Q r\ i g @ n
org	O: g
organ	O: g @ n
organic	O: g { n i k
organically	O: g { n i k l i
organisation	O: g @ n @ s @i S @ n
organisations	O: g @ n @ s @i S @ n z
organisms	O: g @ n @ z @ m z
organist	O: g @ n @ s t
organists	O: g @ n @ s t s
organization	O: g @ n ai z @i S @ n
organizations	O: g @ n ai z @i S @ n z
organized	O: g @ n ai z d
organizing	O: g @ n ai z i N
ori	O: r\ i
oricum	O: r\ i k @ m
oriental	O: r\ i E n t @ l
oriented	O: r\ i@ n t @ d
orientis	O: r\ i@ n t @ s
origin	Q r\ i d_0Z @ n
original	@ r\ i d_0Z @ n @ l
originally	@ r\ i d_0Z @ n @ l i
originating	@ r\ i d_0Z @ n @i t i N
origins	Q r\ i d_0Z @ n z
orioles	O: r\ i@ l z
orkney	O: k n i
orlando	O: l { n d @u
orleans	O: l i@ n z
ormonde	O: m @ n d
ornamental	O: n @ m E n t @ l
ornithischian	O: n @ T @ s k i@ n
orogeny	O: r\ Q d_0Z @ n i
oromo	O: r\ O: m O:
orphan	O: f @ n
orphans	O: f @ n z
orson	O: s @ n
orthodox	O: T @ d Q k s
orthodoxy	O: T @ d Q k s i
orto	O: t @u
orwell	O: w E l
os	@u E s
osb	@u E s b i:
oscar	Q s k @ r\
oscillator	Q s @ l @i t @ r\
ossetia	Q s E t i@
ossetia	Q s i: S @
oswald	Q z w @ l d
other	a D @ r\
others	a D @ z
otto	Q t @u
otto's	Q t @u z
ottoman	Q t @ m @ n
ottomans	Q t @ m @ n z
outdoor	au t d O: r\
outfielder	au t f i: l d @ r\
outlawed	au t l O: d
outlying	au t l ai i N
output	au t p U t
outputs	au t p U t s
outside	au t s ai d
outsourcing	au t s O: s i N
outspoken	au t s p @u k @ n
outstanding	au t s t { n d i N
ov	@u v i:
overall	@u v @ r\ O: l
overbore	@u v @ b O: r\
overgrazing	@u v @ g r\ @i z i N
overhauls	@u v @ h\ O: l z
overlaps	@u v @ l { p s
overline	@u v @ l ai n
overloading	@u v @ l @u d i N
overseas	@u v @ s i: z
overthrew	@u v @ T r\ u:
owain	@u @i n
owen	@u E n
owned	@u n d
owner	@u n @ r\
owners	@u n @ z
ownership	@u n @ S @ p
owning	@u n i N
ox	Q k s
oxford	Q k s f @ d
oxidase	Q k s i d @i z
oxidation	Q k s @ d @i S @ n
oxide	Q k s ai d
oxygen	Q k s i d_0Z @ n
oyly	Oi l i
oyster	Oi s t @ r\
ozone	@u z @u n
p	p i:
paarl	p A: l
pacific	p @ s @ f i k
pacifists	p { s @ f @ s t s
packages	p { k i d_0Z @ z
packed	p { k t
packers	p { k @ z
packet	p { k @ t
packets	p { k @ t s
pact	p { k t
padres	p A: d r\ @i z
pads	p { d z
pagan	p @i g @ n
paganism	p @i g @ n @ z @ m
page	p @i d_0Z
pages	p @i d_0Z @ z
pahlavi	p a l a v i
paid	p @i d
pain	p @i n
paint	p @i n t
painted	p @i n t @ d
painter	p @i n t @ r\
painters	p @i n t @ z
painting	p @i n t i N
paintings	p @i n t i N z
pairs	p e@ z
pakistan	p { k i s t A: n
pakistan's	p { k i s t A: n z
pakistani	p { k i s t A: n i
pal	p { l
palance	p { l @ n s
paleolithic	p { l i @u l @ T i k
palestine	p { l @ s t ai n
palestinian	p { l @ s t i n i@ n
pali	p { l i
palm	p A: m
palmsprings	p A: m s p r\ i N z
palo	p { l @u
pan	p { n
panel	p { n @ l
panther	p { n T @ r\
papacy	p @i p @ s i
papen	p @i p @ n
paper	p @i p @ r\
paperback	p @i p @ b { k
paraguayan	p { r\ @ g w ai @ n
parallel	p { r\ @ l E l
paramedical	p @ r\ @ m E d i k @ l
parametric	p @ r\ @ m E t r\ i k
paramount	p { r\ @ m au n t
paramount's	p { r\ @ m au n t s
pares	p e@ z
paris	p { r\ @ s
parishes	p { r\ i S @ z
parity	p { r\ @ t i
park	p A: k
parker	p A: k @ r\
parker's	p A: k @ r\ z
parkland	p A: k l @ n d
parktown	p A: k t au n
parliament	p A: l @ m @ n t
parliamentary	p A: l @ m E n t r\ i
parliaments	p A: l @ m @ n t s
parnell	p A: n E l
parody	p { r\ @ d i
parsi	p A: s i
parsons	p A: s @ n z
part	p A: t
partial	p A: S @ l
partially	p A: S @ l i
participants	p A: t @ s @ p @ n t s
participation	p A: t @ s @ p @i S @ n
particle	p A: t i k @ l
particles	p A: t i k @ l z
particularly	p @ t i k j U l @ l i
parties	p A: t i z
partisanship	p A: t i z { n S @ p
partner	p A: t n @ r\
partnering	p A: t n @ r\ i N
partners	p A: t n @ z
partnership	p A: t n @ S @ p
party	p A: t i
pascha	p { S a
paschal	p { s k @ l
pass	p A: s
passed	p A: s t
passenger	p { s i n d_0Z @ r\
passes	p A: s @ s
passing	p A: s i N
past	p A: s t
pastis	p A: s t @ s
pat	p { t
patches	p { tS @ z
patent	p @i t @ n t
paternal	p @ t 3: n @ l
paterson	p { t @ s @ n
path	p A: T
pathways	p A: T w @i z
patna	p @i t n @
patriarchs	p @i t r\ i A: k s
patriot	p { t r\ i@ t
patriotic	p { t r\ i Q t i k
patriots	p { t r\ i@ t s
patrons	p @i t r\ @ n z
patronymics	p { t r\ @ n @ m i k s
pattern	p { t @ n
patterns	p { t @ n z
paul	p O: l
pauli	p au l i
pauline	p O: l i: n
paura	p O: r\ @
pay	p @i
pc	p i: s i:
pcr	p i: s i: A: r\
pcs	p i: s i: E s
pdf	p i: d i: E f
pdpa	p i: d i: p i: @i
peabody	p b Q d i
peabody's	p b Q d i z
peace	p i: s
peaceful	p i: s f @ l
peacekeeping	p i: s k i: p i N
peak	p i: k
pearl	p 3: l
peasant	p E z @ n t
peasants	p E z @ n t s
peculiar	p i k j u: l i@ r\
pedal	p E d @ l
pederastic	p E d @ r\ { s t i k
pedro	p E d r\ @u
peer	p i@ r\
peg	p E g
pei's	p ai z
peirce	p i@ s
pelerin	p E l @ r\ i: n
pellaeans	p E l i@ n z
pellets	p E l @ t s
pelts	p E l t s
pelvic	p E l v i k
pen	p E n
peninsula	p E n @ n s j U l @
peninsulas	p E n @ n s j U l @ z
penn	p E n
pennant	p E n @ n t
pennants	p E n @ n t s
pennsylvania	p E n s @ l v @i n i@
people	p i: p @ l
people's	p i: p @ l z
peoples	p i: p @ l z
pepper	p E p @ r\
peppers	p E p @ z
pepys	p E p i z
perceived	p @ s i: v d
percentage	p @ s E n t i d_0Z
perception	p @ s E p S @ n
perceptions	p @ s E p S @ n z
percussion	p @ k a S @ n
percy	p 3: s i
perfect	p 3: f @ k t
perfectly	p 3: f @ k t l i
perform	p @ f O: m
performance	p @ f O: m @ n s
performed	p @ f O: m d
performers	p @ f O: m @ z
performing	p @ f O: m i N
pergamene	p 3: g @ m i: n
period	p i@ r\ i@ d
periodic	p i@ r\ i Q d i k
periods	p i@ r\ i@ d z
peripatetic	p E r\ @ p @ t E t i k
permanent	p 3: m @ n @ n t
perrin's	p E r\ @ n z
perry	p E r\ i
persecution	p 3: s i k j u: S @ n
persei	p 3: s @i
perseus	p 3: s i@ s
persia	p 3: S i@
persian	p 3: S @ n
persistent	p @ s @ s t @ n t
person	p 3: s @ n
person's	p @ s @ n z
personal	p 3: s @ n @ l
personalities	p 3: s @ n { l @ t i z
personifications	p @ s Q n i f i k @i S @ n z
personnel	p 3: s @ n E l
persons	p 3: s @ n z
perspectives	p @ s p E k t @ v z
perth	p 3: T
peru	p @ r\ u:
peru's	p @ r\ u: z
peruvian	p @ r\ U v i@ n
pervasive	p @ v @i s @ v
pervez	p @ v E z
pet	p E t
pete	p i: t
peter	p i: t @ r\
petermaritzburg	p i: t @ m { r\ @ t s b 3: g
peters	p i: t @ z
petersburg	p i: t @ s b 3: g
petition	p @ t i S @ n
petroleum	p i t r\ @u l i@ m
petrus	p E t r\ @ s
pew	p j u:
pharmacology	f A: m @ k Q l @ d_0Z i
pharmacy	f A: m @ s i
phase	f @i z
phased	f @i z d
phenomena	f i n Q m @ n @
phenomena	f @ n Q m @ n a
phenotype	f E n @u t ai p
phenylalanine	f E n @ l { l @ n i: n
phi	f i
philanthropists	f i l { n T r\ @ p @ s t s
philharmonic	f @ l @ m Q n i k
philip	f @ l @ p
philippines	f @ l @ p i: n z
phillips	f @ l @ p s
philosopher	f i l Q s @ f @ r\
philosophers	f i l Q s @ f @ z
philosophiae	f i l Q s @ f i ai
philosophical	f @ l @ s Q f i k @ l
philosophy	f i l Q s @ f i
phone	f @u n
phonetic	f @ n E t i k
photographer	f @ t Q g r\ @ f @ r\
photographers	f @ t Q g r\ @ f @ z
photographic	f @u t @ g r\ { f i k
photography	f @ t Q g r\ @ f i
photon	f @u t Q n
photons	f @u t Q n z
phrases	f r\ @i z @ z
phu	f u:
phylogeny	f ai l Q d_0Z @ n i
physical	f i z i k @ l
physician	f i z i S @ n
physicians	f i z i S @ n z
physicists	f @ z @ s @ s t s
physics	f i z i k s
physik	f @ z i: k
physiographic	f i z i @u g r\ { f i k
physiology	f i z i Q l @ d_0Z i
pi	p ai
pianist	p i@ n @ s t
piano	p i { n @u
pick	p i k
picked	p i k t
pico	p i: k @u
picture	p i k tS @ r\
pictured	p i k tS @ d
pictures	p i k tS @ z
piece	p i: s
pieces	p i: s @ s
piero	p i@ r\ @u
pierre	p i@ r\
pietermaritzburg	p ai @ t @ m { r\ @ t s b 3: g
pietro	p i@ t r\ @u
piety	p ai @ t i
pikes	p ai k s
pile	p ai l
pilgrim	p @ l g r\ @ m
pilgrim's	p @ l g r\ @ m z
pillow	p @ l @u
pillsbury	p @ l s b @ r\ i
pilot	p ai l @ t
pilots	p ai l @ t s
pimville	p @ m v @ l
pimvilli	p @ m v @ l i
pinetown	p ai n t au n
pioneered	p ai @ n i@ d
pioneers	p ai @ n i@ z
pipeline	p ai p l ai n
pipelines	p ai p l ai n z
pirate	p ai r\ @ t
pitch	p i tS
pithunda	p @ T a n d @
pitot	p i t @u
pittsburgh	p @ t s b 3: g
pituitary	p @ t S u@ t r\ i
pius	p i@ s
pivots	p @ v @ t s
pixels	p i k s @ l z
place	p l @i s
places	p l @i s @ s
plagal	p l @i g @ l
plain	p l @i n
plains	p l @i n z
plan	p l { n
planck	p l { N k
plane	p l @i n
planet	p l { n @ t
planets	p l { n @ t s
planned	p l { n d
plans	p l { n z
plant	p l A: n t
plantations	p l { n t @i S @ n z
planters	p l A: n t @ z
planting	p l A: n t i N
plants	p l A: n t s
plastic	p l { s t i k
plastid	p l { s t @ d
plate	p l @i t
plateau	p l { t @u
plates	p l @i t s
platform	p l { t f O: m
platinum	p l { t @ n @ m
platte	p l { t
play	p l @i
played	p l @i d
player	p l @i @ r\
players	p l @i @ z
playing	p l @i i N
playoff	p l @i Q f
playoffs	p l @i Q f s
plays	p l @i z
playstation	p l @i s t @i S @ n
playwrights	p l @i r\ ai t s
pleads	p l i: d z
pleasant	p l E z @ n t
pledge	p l E d_0Z
plein	p l @i n
pleistocene	p l E s t @ s i: n
plh	p i: { l @i tS
plo	p l @u
plural	p l u@ r\ @ l
png	p i: E n d_0Z i:
pocket	p Q k @ t
pods	p Q d z
poe	p @u
poem	p @u @ m
poems	p @u @ m z
poet	p @u @ t
poetic	p @u E t i k
poetry	p @u i t r\ i
poets	p @u @ t s
poids	p Oi d z
point	p Oi n t
pointed	p Oi n t @ d
points	p Oi n t s
poison	p Oi z @ n
poisoning	p Oi z @ n i N
pol	p Q l
poland	p @u l @ n d
poland's	p @u l @ n d z
polar	p @u l @ r\
polaris	p @u l { r\ @ s
polaroid	p @u l @ r\ Oi d
poles	p @u l z
poliakov	p @u l i@ k Q f
police	p @ l i: s
policies	p Q l @ s i s
policy	p Q l @ s i
polisario	p Q l i s A: r\ i @u
polish	p @u l i S
polished	p Q l i S t
political	p @ l @ t i k @ l
politically	p @ l @ t i k l i
politicians	p Q l @ t i S @ n z
politics	p Q l @ t i k s
politiques	p Q l @ t i: k s
poll	p Q l
pollen	p Q l @ n
pollination	p Q l @ n @i S @ n
pollutants	p @ l u: t @ n t s
pollution	p @ l u: S @ n
polo	p @u l @u
polosmak	p @ l Q z m { k
polycyclic	p Q l i s ai k l i k
polyhedra	p Q l i h\ E d r\ @
polymerase	p Q l i m E r\ @i z
polynomial	p Q l i n @u m i@ l
polynomials	p Q l i n @u m i@ l z
polysaccharides	p Q l ai s { k @ r\ ai d z
polytonic	p Q l i t Q n i k
polyunsaturated	p Q l j u: n s { tS @ r\ @i t @ d
pompey	p Q m p i
pongola	p Q N g @u l @
pons	p Q n z
ponti	p Q n t i
pontifical	p Q n t i f i k @ l
pool	p u: l
poor	p u@ r\
poorly	p u@ l i
pop	p Q p
pope	p @u p
popes	p @u p s
popular	p Q p j U l @ r\
popularity	p Q p j U l { r\ @ t i
populated	p Q p j U l @i t @ d
population	p Q p j U l @i S @ n
populations	p Q p j U l @i S @ n z
populist	p Q p j U l @ s t
port	p O: t
portable	p O: t @ b @ l
portfolio	p O: t f @u l i@ @
portions	p O: S @ n z
portrait	p O: t r\ @ t
portray	p O: t r\ @i
portrayed	p O: t r\ @i d
portuguese	p O: tS U g i: z
posed	p @u z d
position	p @ z i S @ n
positional	p @ z i S @ n @ l
positive	p Q z @ t @ v
positively	p Q z @ t @ v l i
positron	p Q z i t r\ @ n
positrons	p Q z i t r\ @ n z
possible	p Q s @ b @ l
possibly	p Q s @ b l i
post	p @u s t
postage	p @u s t i d_0Z
postal	p @u s t @ l
poster	p @u s t @ r\
posthumously	p Q s t j U m @ s l i
postmodern	p @u s t m Q d @ n
postwar	p @u s t w O: r\
pot	p Q t
potawatomi	p Q t @ w Q t @ m i
potch	p Q tS
potchefstroom	p O: t S @ f s t r\ u@ m
potchefstroom	p Q t S @ f s t r\ u: m
potential	p @ t E n S @ l
potentially	p @ t E n S @ l i
potsy	p Q t s i
potter	p Q t @ r\
potter's	p Q t @ z
pour	p O: r\
poverty	p Q v @ t i
powder	p au d @ r\
powell	p au w @ l
power	p au @ r\
powerboat	p au @ b @u t
powered	p au @ d
powerful	p au @ f @ l
powerpc	p au @ p k
powerpoint	p au @ p Oi n t
powers	p au @ z
powiat	p au i @i t
pp	p i: p i:
ppp	p i: p i: p i:
practice	p r\ { k t @ s
prairie	p r\ e@ r\ i
praise	p r\ @i z
prayer	p r\ e@ r\
prd	p i: A: r\ d i:
pre	p r\ i:
preached	p r\ i: tS t
precedes	p r\ i s i: d z
precious	p r\ E S @ s
precipitation	p r\ @ s @ p @ t @i S @ n
precise	p r\ i s ai s
precision	p r\ i s i Z n
predator	p r\ E d @ t @ r\
predicted	p r\ @ d i k t @ d
predictions	p r\ @ d i k S @ n z
predictive	p r\ @ d i k t @ v
predominant	p r\ i d Q m @ n @ n t
predominantly	p r\ i d Q m @ n @ n t l i
preface	p r\ E f @ s
prefectural	p r\ i: f E k tS @ r\ @ l
pregnant	p r\ E g n @ n t
premier	p r\ E m i@ r\
premiering	p r\ E m i@ r\ i N
premium	p r\ i: m i@ m
prepared	p r\ i p e@ d
presburger	p r\ E z b 3: g @ r\
presbyterian	p r\ E z b @ t e@ r\ i@ n
presbyterians	p r\ E z b @ t e@ r\ i@ n z
prescrire	p r\ @ s k r\ ai r\
presence	p r\ E z @ n s
present	p r\ E z @ n t
presentation	p r\ E z @ n t @i S @ n
presents	p r\ E z @ n t s
preservation	p r\ E z @ v @i S @ n
preserves	p r\ i z 3: v z
presidency	p r\ E z @ d @ n s i
president	p r\ E z @ d @ n t
presidential	p r\ E z i d E n S @ l
presidents	p r\ E z @ d @ n t s
presley	p r\ E z l i
presley's	p r\ E z l i z
presocratic	p r\ i: s @u k r\ { t i k
press	p r\ E s
pressure	p r\ E S @ r\
preston	p r\ E s t @ n
pretoria	p r\ i t O: r\ i@
prevent	p r\ i v E n t
previous	p r\ i: v i@ s
previously	p r\ i: v i@ s l i
prey	p r\ @i
priboi	p r\ i b Oi
price	p r\ ai s
priced	p r\ ai s t
prices	p r\ ai s @ s
priest	p r\ i: s t
priests	p r\ i: s t s
prima	p r\ i: m @
primarily	p r\ ai m @ r\ @ l i
primary	p r\ ai m @ r\ i
prime	p r\ ai m
primitive	p r\ @ m @ t @ v
primus	p r\ ai m @ s
prince	p r\ @ n s
princeton	p r\ @ n s t @ n
principal	p r\ @ n s @ p @ l
principality	p r\ @ n s @ p { l @ t i
principia	p r\ @ n s i p i@
principle	p r\ @ n s @ p @ l
printed	p r\ @ n t @ d
printer	p r\ @ n t @ r\
printers	p r\ @ n t @ z
printing	p r\ @ n t i N
printmakers	p r\ @ n t m @i k @ z
prior	p r\ ai @ r\
priorities	p r\ ai Q r\ @ t i z
priscilla	p r\ @ s @ l @
prison	p r\ @ z @ n
prisoners	p r\ @ z n @ z
prithvi	p r\ i T v i
private	p r\ ai v @ t
privately	p r\ ai v @ t l i
privatisation	p r\ ai v @ t ai z @i S @ n
privy	p r\ i v i
prix	p r\ i
prize	p r\ ai z
pro	p r\ @u
probability	p r\ Q b @ b @ l @ t i
probably	p r\ Q b @ b l i
probe	p r\ @u b
problem	p r\ Q b l @ m
problems	p r\ Q b l @ m z
procedural	p r\ @ s i: d_0Z @ r\ @ l
procedure	p r\ @ s i: d_0Z @ r\
proceeds	p r\ @u s i: d z
process	p r\ @u s E s
processed	p r\ @u s E s t
processes	p r\ @u s E s @ s
processing	p r\ @u s E s i N
processors	p r\ @u s E s @ z
proclamation	p r\ Q k l @ m @i S @ n
produce	p r\ Q d j u: s
produced	p r\ @ d j u: s t
producer	p r\ @ d j u: s @ r\
producers	p r\ @ d j u: s @ z
produces	p r\ @ d j u: s @ s
producing	p r\ @ d j u: s i N
product	p r\ Q d a k t
production	p r\ @ d a k S @ n
productions	p r\ @ d a k S @ n z
products	p r\ Q d a k t s
professional	p r\ @ f E S @ n @ l
professionals	p r\ @ f E S @ n @ l z
professor	p r\ @ f E s @ r\
proffesor	p r\ Q f s @ r\
profile	p r\ @u f ai l
profit	p r\ Q f @ t
profitable	p r\ Q f @ t @ b @ l
progenitors	p r\ @u d_0Z E n @ t @ z
program	p r\ @u g r\ { m
programmable	p r\ @u g r\ { m @ b @ l
programme	p r\ @u g r\ { m
programmed	p r\ @u g r\ { m d
programmers	p r\ @u g r\ { m @ z
programmes	p r\ @u g r\ { m z
programming	p r\ @u g r\ { m i N
programs	p r\ @u g r\ { m z
progress	p r\ @u g r\ E s
progressive	p r\ @ g r\ E s @ v
progressive	p r\ @u g r\ E s @ v
prohibitorum	p r\ @u h\ i b @ t @ r\ @ m
prohibits	p r\ @ h\ i b @ t s
prohibits	p r\ @u h\ i b @ t s
project	p r\ Q d_0Z E k t
project's	p r\ @ d_0Z E k t s
projective	p r\ @ d_0Z E k t @ v
projects	p r\ Q d_0Z E k t s
projet	p r\ @u d_0Z E t
prometheus	p r\ @ m i T i@ s
prominent	p r\ Q m @ n @ n t
promised	p r\ Q m @ s t
promises	p r\ Q m @ s @ s
promising	p r\ Q m i s i N
promoting	p r\ @ m @u t i N
pronouns	p r\ @u n au n z
pronunciation	p r\ @ n a n s i @i S @ n
pronunciations	p r\ @ n a n s i @i S @ n z
proofs	p r\ u: f s
propaganda	p r\ Q p @ g { n d @
propagandist	p r\ Q p @ g { n d @ s t
propagandists	p r\ Q p @ g { n d @ s t s
propagating	p r\ Q p @ g @i t i N
propagation	p r\ Q p @ g @i S @ n
propellant	p r\ @ p E l @ n t
proper	p r\ Q p @ r\
properties	p r\ Q p @ t i z
property	p r\ Q p @ t i
prophecy	p r\ Q f @ s i
prophet	p r\ Q f @ t
prophets	p r\ Q f @ t s
proponents	p r\ @ p @u n @ n t s
proposals	p r\ @ p @u z @ l z
proposed	p r\ @ p @u z d
propositional	p r\ Q p @ z i S @ n @ l
propulsion	p r\ @ p a l S @ n
prose	p r\ @u z
prosopography	p r\ Q s @ p Q g r\ @ f i
prospects	p r\ Q s p E k t s
protagonists	p r\ @ t { g @ n @ s t s
protea	p r\ @u t i@
protect	p r\ @ t E k t
protection	p r\ @ t E k S @ n
protein	p r\ @u t i: n
proteins	p r\ @u t i: n z
proteomic	p r\ @u t i Q m i k
protestant	p r\ Q t @ s t @ n t
protestants	p r\ Q t @ s t @ n t s
protocol	p r\ @u t @ k Q l
protocols	p r\ @u t @ k Q l z
proton	p r\ @u t Q n
prototype	p r\ @u t @ t ai p
prove	p r\ u: v
proved	p r\ u: v d
proven	p r\ u: v @ n
provide	p r\ @ v ai d
provided	p r\ @ v ai d @ d
provider	p r\ @ v ai d @ r\
providers	p r\ @ v ai d @ z
provides	p r\ @ v ai d z
providing	p r\ @ v ai d i N
province	p r\ Q v @ n s
provinces	p r\ Q v @ n s @ s
provincial	p r\ @ v i n S @ l
proving	p r\ u: v i N
provisional	p r\ @ v i Z @ n @ l
provisionally	p r\ @ v i Z @ n @ l i
proyset	p r\ Oi s E t
prussia	p r\ a S i@
pseudo	s j u: d @u
pseudocode	s j u: d @u k @u d
pseudorandom	s j u: d @u r\ { n d @ m
psm	p i: E s E m
psychedelic	s ai k @ d @ l i k
psychiatric	s ai k i { t r\ i k
psychoanalytic	s ai k @u { n @ l @ t i k
psychological	s ai k @ l Q d_0Z i k @ l
psychology	s ai k Q l @ d_0Z i
ptolemaic	t Q l @ m @i i k
ptolemy	t Q l @ m i
ptsd	p i: t i: E s d i:
public	p a b l i k
publication	p a b l i k @i S @ n
publications	p a b l i k @i S @ n z
publicly	p a b l i k l i
publique	p a b l i: k
published	p a b l i S t
publisher	p a b l i S @ r\
publishers	p a b l i S @ z
publishing	p a b l i S i N
puebloan	p w E b l @u n
pulitzer	p U l @ t z @ r\
pull	p U l
pulling	p U l i N
pulp	p a l p
pulsating	p a l s @i t i N
pulse	p a l s
pump	p a m p
punch	p a n tS
punched	p a n tS t
punic	p j u: n i k
punishment	p a n i S m @ n t
punjabi	p a n d_0Z A: b i
punk	p a N k
puplication	p a p l i k @i S @ n
purchasing	p 3: tS @ s i N
purdue	p 3: d u:
purely	p j u@ l i
purple	p 3: p @ l
purpose	p 3: p @ s
purse	p 3: s
pursued	p @ s j u: d
pusat	p u: s { t
pushed	p U S t
putin	p j u: t @ n
puzzle	p a z @ l
pyrene	p ai @ r\ i: n
pyrotechnic	p ai r\ @u t E k n i k
pythagorean	p ai T { g @ r\ i@ n
python	p ai T @ n
qabalists	k { b @ l @ s t s
qadhafi	k a d { f i
qarase	k a r\ @i z
qasim	k a s i m
qatar	k { t A: r\
qcd	k j u: s i: d i:
qi	k j u: ai
quad	k w Q d
quake	k w @i k
qualified	k w Q l @ f ai d
qualifier	k w Q l @ f ai @ r\
qualities	k w Q l @ t i z
quality	k w Q l @ t i
quantities	k w Q n t @ t i z
quantum	k w Q n t @ m
quarks	k w A: k s
quarrel	k w Q r\ @ l
quarter	k w O: t @ r\
quartet	k w O: t E t
quartets	k w O: t E t s
quartz	k w O: t s
queen	k w i: n
queens	k w i: n z
queenstown	k w i: n z t au n
quest	k w E s t
question	k w E s tS @ n
questions	k w E s tS @ n z
quickly	k w i k l i
quicktime	k w i k t ai m
quincy	k w @ n s i
quite	k w ai t
quotation	k w @u t @i S @ n
quote	k w @u t
r	A: r\
raaf	r\ A: f
rabbi	r\ { b ai
rabbi's	r\ { b ai z
rabbis	r\ { b ai z
rabbit	r\ { b @ t
rabbitohs	r\ { b @ t @u z
race	r\ @i s
racehorse	r\ @i s h\ O: s
raceways	r\ @i s w @i z
racial	r\ @i S @ l
racing	r\ @i s i N
racquetball	r\ { k @ t b O: l
radar	r\ @i d A: r\
radial	r\ @i d i@ l
radiation	r\ @i d i @i S @ n
radiative	r\ @i d @ t @ v
radical	r\ { d i k @ l
radio	r\ @i d i@ @
radioactive	r\ @i d i@ U { k t @ v
radioisotope	r\ @i d i@ U ai s @ t @u p
radiometric	r\ @i d i @u m E t r\ i k
radix	r\ @i d i k s
raf	A: r\ @i E f
rahman	r\ A: m @ n
raiding	r\ @i d i N
rail	r\ @i l
railgauge	r\ @i l g @i d_0Z
railroad	r\ @i l r\ @u d
railway	r\ @i l w @i
railways	r\ @i l w @i z
rain	r\ @i n
rainer	r\ @i n @ r\
rainfall	r\ @i n f O: l
rainforest	r\ @i n f Q r\ @ s t
raise	r\ @i z
raised	r\ @i z d
raleigh	r\ { l i
rally	r\ { l i
ralph	r\ { l f
ramjet	r\ { m d_0Z E t
ramon	r\ @ m @ n
ramos	r\ A: m O: s
rams	r\ { m z
ramsar	r\ { m s A: r\
ran	r\ { n
rand	r\ { n d
randburg	r\ { n d b 3: g
randfontein	r\ { n d f @ n t @i n
randfontein	r\ { n d f @ n t i: n
randolph	r\ { n d Q l f
random	r\ { n d @ m
randomized	r\ { n d @ m ai z d
randomly	r\ { n d @ m l i
range	r\ @i n d_0Z
ranger	r\ @i n d_0Z @ r\
rangers	r\ @i n d_0Z @ r\ z
ranges	r\ @i n d_0Z @ z
ranging	r\ @i n d_0Z i N
ranjit	r\ { n d_0Z @ t
rank	r\ { N k
rankings	r\ { N k i N z
ranks	r\ { N k s
rapcore	r\ { p k O: r\
rapid	r\ { p @ d
rapidly	r\ { p @ d l i
rapids	r\ { p @ d z
rapists	r\ @i p @ s t s
rappers	r\ { p @ z
rare	r\ e@ r\
rarely	r\ e@ l i
rashid	r\ { S i: d
raspberry	r\ A: s b E r\ i
rate	r\ @i t
rates	r\ @i t s
ratified	r\ { t @ f ai d
rating	r\ @i t i N
ratio	r\ @i S i@ @
rational	r\ { S @ n @ l
ratios	r\ @i S i@ U z
raw	r\ O:
rawlinson	r\ O: l @ n s @ n
ray	r\ @i
raymond	r\ @i m @ n d
rays	r\ @i z
rbi	A: r\ b i: ai
rca	A: r\ s i: @i
reach	r\ i: tS
reaction	r\ i { k S @ n
reactions	r\ i { k S @ n z
reactive	r\ i { k t @ v
reactor	r\ i { k t @ r\
reactors	r\ i { k t @ z
read	r\ E d
readable	r\ i: d @ b @ l
reaffiliation	r\ i: @ f @ l i @i S @ n
reagan	r\ @i g @ n
reagan	r\ i: g @ n
reaktor	r\ i { k t @ r\
real	r\ i@ l
reality	r\ i { l @ t i
really	r\ i@ l i
rear	r\ i@ r\
reason	r\ i: z @ n
reasonable	r\ i: z n @ b @ l
reasons	r\ i: z @ n z
rebel	r\ E b @ l
rebellion	r\ i b E l i@ n
rebellions	r\ i b E l i@ n z
rebranded	r\ i b r\ { n d @ d
recaptured	r\ i: k { p tS @ d
receive	r\ i s i: v
received	r\ i s i: v d
receives	r\ i s i: v z
receiving	r\ i s i: v i N
recent	r\ i: s @ n t
recently	r\ i: s @ n t l i
receptor	r\ i s E p t @ r\
recipients	r\ i s i p i@ n t s
recognition	r\ E k @ g n i S @ n
recognized	r\ E k @ g n ai z d
recognizes	r\ E k @ g n ai z @ z
reconfirming	r\ i: k @ n f 3: m i N
reconnaissance	r\ i k Q n @ s @ n s
reconstruction	r\ i: k @ n s t r\ a k S @ n
record	r\ E k O: d
recorded	r\ i k O: d @ d
recorders	r\ i k O: d @ z
recording	r\ i k O: d i N
recordings	r\ i k O: d i N z
records	r\ E k O: d z
recounts	r\ i k au n t s
recreated	r\ i: k r\ i: @i t @ d
recreation	r\ E k r\ i @i S @ n
recreational	r\ E k r\ i @i S @ n @ l
rectangular	r\ E k t { N g j U l @ r\
recurrence	r\ i k a r\ @ n s
recurring	r\ i k 3: r\ i N
recursion	r\ i k 3: S @ n
recursive	r\ i k 3: s @ v
recyclable	r\ i: s ai k l @ b @ l
red	r\ E d
redshift	r\ E d S @ f t
reduce	r\ i d j u: s
reduced	r\ i d j u: s t
reduces	r\ i d j u: s @ s
reducing	r\ i d j u: s i N
reductio	r\ i d a k S i@ @
reduction	r\ i d a k S @ n
reed	r\ i: d
reeds	r\ i: d z
reef	r\ i: f
reestablished	r\ i: s t { b l i S t
ref	r\ E f
reference	r\ E f r\ @ n s
references	r\ E f r\ @ n s @ s
referential	r\ E f @ r\ E n S @ l
refers	r\ i f 3: z
refine	r\ i f ai n
reflabel	r\ E f l @i b @ l
reflecting	r\ i f l E k t i N
reflection	r\ i f l E k S @ n
reform	r\ i f O: m
reformation	r\ E f @ m @i S @ n
reformed	r\ i f O: m d
refuge	r\ E f j u: d_0Z
refugees	r\ E f j U d_0Z i: z
regarding	r\ i g A: d i N
regards	r\ i g A: d z
regent's	r\ i: d_0Z @ n t s
regime	r\ @i Z i: m
region	r\ i: d_0Z @ n
regional	r\ i: d_0Z @ n @ l
regions	r\ i: d_0Z @ n z
registered	r\ E d_0Z @ s t @ d
registers	r\ E d_0Z @ s t @ z
registry	r\ E d_0Z @ s t r\ i
regular	r\ E g j U l @ r\
regularly	r\ E g j U l @ l i
regulating	r\ E g j U l @i t i N
regulations	r\ E g j U l @i S @ n z
rehash	r\ i: h\ { S
reigning	r\ @i n i N
reinforcing	r\ i: @ n f O: s i N
rejected	r\ i d_0Z E k t @ d
rejects	r\ i: d_0Z E k t s
related	r\ i l @i t @ d
relates	r\ i l @i t s
relation	r\ i l @i S @ n
relational	r\ i l @i S @ n @ l
relations	r\ i l @i S @ n z
relationship	r\ i l @i S @ n S @ p
relationships	r\ i l @i S @ n S @ p s
relatively	r\ E l @ t @ v l i
relatives	r\ E l @ t @ v z
relativity	r\ E l @ t @ v @ t i
relay	r\ i: l @i
release	r\ i l i: s
released	r\ i l i: s t
releasing	r\ i l i: s i N
reliable	r\ i l ai @ b @ l
relies	r\ i l ai z
relieved	r\ i l i: v d
religio	r\ i l i d_0Z i@ @
religion	r\ i l i d_0Z @ n
religions	r\ i l i d_0Z @ n z
religious	r\ i l i d_0Z @ s
rely	r\ i l ai
remain	r\ i m @i n
remainder	r\ i m @i n d @ r\
remained	r\ i m @i n d
remaining	r\ i m @i n i N
remains	r\ i m @i n z
remarkably	r\ i m A: k @ b l i
remastered	r\ i m A: s t @ d
reminds	r\ i m ai n d z
remodeled	r\ i: m Q d @ l d
remote	r\ i m @u t
remove	r\ i m u: v
removed	r\ i m u: v d
renaissance	r\ i n @i s @ n s
renal	r\ i: n @ l
rendered	r\ E n d @ d
rendering	r\ E n d @ r\ i N
rene	r\ @ n @i
renew	r\ @ n j u:
renewable	r\ @ n j u: @ b @ l
rent	r\ E n t
rental	r\ E n t @ l
repeated	r\ i p i: t @ d
repeatedly	r\ i p i: t @ d l i
replace	r\ i p l @i s
replaced	r\ i p l @i s t
replacement	r\ i p l @i s m @ n t
replicants	r\ E p l i k @ n t s
replicas	r\ E p l i k @ z
replies	r\ i p l ai z
report	r\ i p O: t
reported	r\ i p O: t @ d
reportedly	r\ i p O: t @ d l i
reporting	r\ i p O: t i N
represent	r\ E p r\ i z E n t
representation	r\ E p r\ i z E n t @i S @ n
representative	r\ E p r\ i z E n t @ t @ v
representatives	r\ E p r\ i z E n t @ t @ v z
represented	r\ E p r\ i z E n t @ d
representing	r\ E p r\ i z E n t i N
represents	r\ E p r\ i z E n t s
repression	r\ i p r\ E S @ n
repressions	r\ i p r\ E S @ n z
repressive	r\ i p r\ E s @ v
republic	r\ i p a b l i k
republican	r\ i p a b l i k @ n
republicans	r\ i p a b l i k @ n z
republics	r\ i p a b l i k s
repudiated	r\ i p j u: d i @i t @ d
request	r\ i k w E s t
requested	r\ i k w E s t @ d
requests	r\ i k w E s t s
requiem	r\ E k w i@ m
require	r\ i k w ai @ r\
requirements	r\ i k w ai @ m @ n t s
requires	r\ i k w ai @ z
rescue	r\ E s k j u:
rescued	r\ E s k j u: d
research	r\ i s 3: tS
researchers	r\ i s 3: tS @ z
resemblance	r\ i z E m b l @ n s
resemble	r\ i z E m b @ l
reserve	r\ i z 3: v
reserves	r\ i z 3: v z
residence	r\ E z @ d @ n s
residents	r\ E z @ d @ n t s
residues	r\ E z i d j u: z
resigning	r\ i z ai n i N
resins	r\ E z @ n z
resistance	r\ @ z @ s t @ n s
resisted	r\ @ z @ s t @ d
resisters	r\ @ z @ s t @ z
resolution	r\ E z @ l u: S @ n
resolutions	r\ E z @ l u: S @ n z
resonance	r\ E z @ n @ n s
resort	r\ i z O: t
resource	r\ i z O: s
resources	r\ i z O: s @ s
respectively	r\ i s p E k t @ v l i
respiratory	r\ @ s p @ r\ @ t r\ i
responsibility	r\ i s p Q n s @ b @ l @ t i
rest	r\ E s t
restaurant	r\ E s t r\ Q n t
rested	r\ E s t @ d
resting	r\ E s t i N
restoration	r\ E s t @ r\ @i S @ n
restore	r\ i s t O: r\
restrict	r\ @ s t r\ i k t
result	r\ i z a l t
resulted	r\ i z a l t @ d
results	r\ i z a l t s
resumed	r\ @ z j u: m d
resurrection	r\ E z @ r\ E k S @ n
retail	r\ i: t @i l
retained	r\ i t @i n d
retaliatory	r\ i t { l i@ t r\ i
reticulum	r\ i t i k j U l @ m
retreat	r\ i t r\ i: t
return	r\ i t 3: n
returned	r\ i t 3: n d
returns	r\ i t 3: n z
reuben	r\ u: b @ n
reuptake	r\ i a p t @i k
revealed	r\ i v i: l d
revenue	r\ E v @ n j u:
reverse	r\ i v 3: s
review	r\ @ v j u:
reviewers	r\ @ v j u: @ z
reviews	r\ @ v j u: z
revised	r\ i v ai z d
revival	r\ i v ai v @ l
revivalist	r\ i v ai v @ l @ s t
revolted	r\ i v @u l t @ d
revolution	r\ E v @ l u: S @ n
revolutionary	r\ E v @ l u: S @ n r\ i
revulsion	r\ i v a l S @ n
reza	r\ E z @
rgb	A: r\ d_0Z i: b i:
rhetoric	r\ E t @ r\ i k
rhetoricians	r\ E t @ r\ i S @ n z
rhine	r\ ai n
ribbentrop	r\ @ b E n t r\ Q p
rice	r\ ai s
rice's	r\ ai s @ z
rich	r\ i tS
richard	r\ i tS @ d
richard's	r\ i tS @ d z
richards	r\ i tS @ d z
richmond	r\ i tS m @ n d
rider	r\ ai d @ r\
rides	r\ ai d z
ridge	r\ i d_0Z
ridgefield	r\ i d_0Z f i: l d
ridgeway	r\ i d_0Z w @i
ridiculed	r\ i d i k j u: l d
riemann	r\ i: m @ n
riemannian	r\ i: m { n i@ n
rifle	r\ ai f @ l
rifles	r\ ai f @ l z
rift	r\ @ f t
right	r\ ai t
rights	r\ ai t s
rigorous	r\ i g @ r\ @ s
rigvedic	r\ i g v @i d i k
rilke	r\ @ l k
ring	r\ i N
rise	r\ ai z
rising	r\ ai z i N
risk	r\ @ s k
rite's	r\ ai t s
ritual	r\ i tS u@ l
rival	r\ ai v @ l
rival's	r\ ai v @ l s
rivalry	r\ ai v @ l r\ i
river	r\ @ v @ r\
rivers	r\ @ v @ z
riverside	r\ @ v @ s ai d
rjuna	A: r\ d_0Z U n @
road	r\ @u d
robert	r\ Q b 3: t
roberts	r\ Q b 3: t s
robotics	r\ @u b Q t i k s
robots	r\ @u b Q t s
robust	r\ @u b a s t
roch	r\ Q k
roch	r\ Q tS
roche	r\ Q S
rock	r\ Q k
rocket	r\ Q k @ t
rocks	r\ Q k s
rocky	r\ Q k i
rodents	r\ @u d @ n t s
rodham	r\ @ d @ m
roger	r\ Q d_0Z @ r\
rogier	r\ @u d_0Z i@ r\
rohe	r\ @u
roland	r\ @u l @ n d
role	r\ @u l
roles	r\ @u l z
roller	r\ @u l @ r\
rolling	r\ @u l i N
rom	r\ Q m
roman	r\ @u m @ n
romana	r\ @u m A: n @
romance	r\ @ m { n s
romance	r\ @u m { n s
romanian	r\ @ m @i n i@ n
romano	r\ @u m A: n @u
romans	r\ @u m @ n z
rome	r\ @u m
rompuy	r\ Q m p ai
romulan	r\ Q m j U l @ n
ron	r\ Q n
ronald	r\ Q n @ l d
rond	r\ Q n d
rondebult	r\ Q n d @ b @ l t
ronnie	r\ Q n i
room	r\ u: m
roosevelt	r\ @u z @ v E l t
root	r\ u: t
roots	r\ u: t s
rosa	r\ @u z @
rose	r\ @u z
rosecrans	r\ @u z @ k r\ { n z
roses	r\ @u z @ z
rosseline	r\ Q s @ l i: n
rosta	r\ Q s t @
rotating	r\ @u t @i t i N
rotation	r\ @u t @i S @ n
rough	r\ a f
roulette	r\ u: l E t
round	r\ au n d
rover	r\ @u v @ r\
rovere	r\ Q v @ r\ E
row	r\ au
rowan	r\ @u w @ n
rowing	r\ au i N
roy	r\ Oi
royal	r\ Oi @ l
royale	r\ Oi @ l
royals	r\ Oi @ l z
rozelle	r\ @u z E l
rub	r\ a b
rubber	r\ a b @ r\
rubens	r\ u: b @ n z
rudd	r\ a d
rugby	r\ a g b i
rule	r\ u: l
ruled	r\ u: l d
ruler	r\ u: l @ r\
rulers	r\ u: l @ z
rules	r\ u: l z
ruling	r\ u: l i N
rumani	r\ u: m A: n i
rumbles	r\ a m b @ l z
rumsfeld	r\ a m s f E l d
run	r\ a n
runner	r\ a n @ r\
running	r\ a n i N
runs	r\ a n z
rupert	r\ u: p 3: t
rural	r\ u: r\ @ l
rural	r\ u@ r\ @ l
rush	r\ a S
russel	r\ a s @ l
russell	r\ a s @ l
russia	r\ a S i@
russia's	r\ a S i@ z
russian	r\ a S @ n
russians	r\ a S @ n z
rustenburg	r\ a s t @ n b 3: g
rusternburg	r\ a s t @ n b 3: g
ruthenian	r\ T i: n i@ n
ruthless	r\ u: T l @ s
rutlish	r\ a t l i S
ryazan	r\ i @ z { n
s	E s
sa	E s @i
sa	s a
sabiha	s @ b i h\ @
sabir	s @ b i: r\
sacramento	s { k r\ @ m E n t @u
sacu	s { k u:
sadc	E s @i d i: s i:
sadler's	s { d l @ z
safe	s @i f
safeguarding	s @i f g A: d i N
safeguards	s @i f g A: d z
safely	s @i f l i
safety	s @i f t i
saga	s A: g @
said	s E d
sailed	s @i l d
sailing	s @i l i N
saint	s @i n t
saints	s @i n t s
salamis	s @ l A: m i z
salem	s @i l @ m
sales	s @i l z
salinities	s @ l @ n @ t i z
salt	s O: l t
saluki	s @ l u: k i
salvadoran	s { l v @ d O: r\ @ n
sam	s { m
samba	s a m b a
samba	s { m b @
samoa	s @ m @u @
sample	s A: m p @ l
samples	s A: m p @ l z
sampson	s { m s @ n
samuel	s { m j u: @ l
samuel's	s { m i@ l z
san	s { n
sanders	s { n d @ z
sandf	E s @i E n d i: E f
sandler's	s { n d l @ r\ z
sandra	s { n d r\ @
sandrift	s { n d r\ @ f t
sands	s { n d z
sandton	s { n t @ n
sandwich	s { n w i d_0Z
sang	s { N
sanskrit	s { n s k r\ @ t
sant	s { n t
santa	s { n t @
sarah	s e@ r\ @
sarajevo	s { r\ @ j E v @u
saratoga	s { r\ @ t @u g @
sargent	s A: d_0Z @ n t
sarkozy	s A: k @u z i
sarkozy	s A: k @ z i:
sarnia	s A: n i@
sas's	E s @i E s @ z
sas's	s { s @ z
sash	s { S
sasolburg	s { s @ l b 3: g
satan	s @i t @ n
satellite	s { t @ l ai t
satellites	s { t @ l ai t s
satire	s { t ai @ r\
satirical	s @ t @ r\ i k @ l
satirists	s { t @ r\ @ s t s
satisfiability	s { t @ s f ai @ b @ l @ t i
satisfied	s { t @ s f ai d
satisfies	s { t @ s f ai z
sattva	s { t v @
saturated	s { tS @ r\ @i t @ d
saturday	s { t @ d i
saturn	s { t 3: n
saudi	s au d i
sauk	s a k
saul	s O: l
savage	s { v i d_0Z
savannah	s @ v { n @
saved	s @i v d
saving	s @i v i N
saw	s O:
saxon	s { k s @ n
saxons	s { k s @ n z
says	s E z
scale	s k @i l
scales	s k @i l z
scanned	s k { n d
scanning	s k { n i N
scarce	s k e@ s
scattering	s k { t @ r\ i N
scca	E s s i: s i: @i
scene	s i: n
sceptics	s k E p t i k s
scheme	s k i: m
schengen	S E N g @ n
schiefner	S i f n @ r\
schisms	s k i z @ m z
schoenberg	S 3: n b 3: g
schofield	S @u f i: l d
scholar	s k Q l @ r\
scholars	s k Q l @ z
scholarship	s k Q l @ S @ p
scholastic	s k @ l { s t i k
schonkenville	S Q N k @ n v @ l
school	s k u: l
schools	s k u: l z
schoolteachers	s k u: l t i: tS @ z
schopenhauer	S @u p @ n h\ au @ r\
schweizer	S w i: z @ r\
schwellnus	S w E l n @ s
sci	s ai
science	s ai @ n s
sciences	s ai @ n s @ s
scientific	s ai @ n t @ f i k
scientific	s ai @ n t i f i k
scientifically	s ai @ n t @ f i k l i
scientifically	s ai @ n t i f i k l i
scientists	s ai @ n t @ s t s
scleroderma	s k l E r\ @ d 3: m @
sclerosis	s k l @ r\ @u s @ s
scorched	s k O: tS t
score	s k O: r\
scored	s k O: d
scores	s k O: z
scoring	s k O: r\ i N
scotia	s k @u S i@
scotland	s k Q t l @ n d
scott	s k Q t
scott's	s k Q t s
scottish	s k Q t i S
screen	s k r\ i: n
screenplay	s k r\ i: n p l @i
screenwriters	s k r\ i: n r\ ai t @ z
script	s k r\ @ p t
scripting	s k r\ @ p t i N
scrolls	s k r\ @u l z
scrub	s k r\ a b
scuba	s k U b @
sculptors	s k a l p t @ z
sculpture	s k a l p tS @ r\
sdlp	E s d i: { l p i:
sea	s i:
sea's	s i: z
seaborg	s i: b O: g
seamounts	s i: m au n t s
sean	S O: n
search	s 3: tS
searches	s 3: tS @ z
seas	s i: z
season	s i: z @ n
seat	s i: t
seats	s i: t s
seaway	s i: w @i
second	s E k @ n d
secondary	s E k @ n d r\ i
secret	s i: k r\ @ t
secretariat	s E k r\ @ t e@ r\ i@ t
secretaries	s E k r\ @ t r\ i z
secretary	s E k r\ @ t r\ i
section	s E k S @ n
sections	s E k S @ n z
sector	s E k t @ r\
sectors	s E k t @ z
secure	s @ k j u@ r\
secures	s @ k j u@ z
security	s @ k j u@ r\ @ t i
sedimentary	s E d i m E n t r\ i
sediments	s E d @ m @ n t s
see	s i:
seedorf	s i: d O: f
seeds	s i: d z
seek	s i: k
seeking	s i: k i N
seemingly	s i: m i N l i
seen	s i: n
seepolizei	s i: p Q l i t s ai
sega	s @i g @
seiches	s @i S @ z
seizure	s i: Z @ r\
selassie	s @ l { s i
selborne	s l b O: n
selbourne	s l b @ n
select	s @ l E k t
selected	s @ l E k t @ d
selection	s @ l E k S @ n
selective	s @ l E k t @ v
seleucid	s @ l u: s @ d
self	s E l f
selinah	s l @ n @
seljuk	s E l d_0Z u: k
seller	s E l @ r\
selling	s E l i N
semantics	s @ m { n t i k s
semiconductor	s E m i k @ n d a k t @ r\
seminary	s E m @ n @ r\ i
seminole	s E m i n @u l
semitic	s @ m i t i k
semitism	s E m i t @ z @ m
senate	s E n @ t
senator	s E n @ t @ r\
senators	s E n @ t @ z
send	s E n d
senior	s i: n i@ r\
sense	s E n s
sensi's	s E n s ai z
sensitive	s E n s @ t @ v
sensors	s E n s @ z
sent	s E n t
separate	s E p r\ @ t
september	s E p t E m b @ r\
septimius	s E p t @ m i@ s
sequence	s i: k w @ n s
sequences	s i: k w @ n s @ s
serb	s 3: b
serbia	s 3: b i@
serbia's	s 3: b i@ z
serbian	s 3: b i@ n
seri	s E r\ i
serial	s i@ r\ i@ l
series	s i@ r\ i: z
seriously	s i@ r\ i@ s l i
serotonin	s E r\ @ t @u n @ n
served	s 3: v d
server	s 3: v @ r\
servers	s 3: v @ z
service	s 3: v @ s
services	s 3: v @ s @ s
sescu	s E s k u:
set	s E t
seth	s E T
sets	s E t s
settled	s E t @ l d
settlement	s E t l m @ n t
settlements	s E t l m @ n t s
settlers	s E t l @ z
setup	s E t a p
seven	s E v @ n
seventeenth	s E v @ n t i: n T
seventh	s E v @ n T
several	s E v r\ @ l
severan	s E v i@ r\ @ n
severances	s E v @ r\ @ n s @ s
severe	s @ v i@ r\
severed	s E v @ d
severely	s @ v i@ l i
severing	s E v @ r\ i N
severus	s E v @ r\ @ s
sexual	s E k S u@ l
sexually	s E k S u@ l i
sfn	E s E f E n
sggsie	s g s i
sgi	E s d_0Z i: ai
sh	E s @i tS
shadrack	S { d r\ { k
shah	S A:
shakespeare	S @i k s p i@ r\
shale	S @i l
shall	S { l
shanghai	S { N h\ ai
shannon's	S { n @ n z
sharapova	S { r\ @ p @u v a
sharashka	S { r\ @ S k @
shared	S e@ d
sharing	S e@ r\ i N
sharonsville	S { r\ @ n z v @ l
sharp	S A: p
sharpeville	S A: p v @ l
shaving	S @i v i N
shaw	S O:
she	S i:
shed	S E d
sheet	S i: t
sheets	S i: t s
sheikh	S @i k
shell	S E l
shelley	S E l i
shelling	S E l i N
shells	S E l z
shelly	S E l i
shelter	S E l t @ r\
shenouda	S @ n au d @
shepherd	S E p @ d
sher	S @ r\
sheridan	S E r\ @ d @ n
sherman	S 3: m @ n
sherman's	S 3: m @ n s
shi	E s @i tS ai
shift	S @ f t
shikai	S i k ai
shining	S ai n i N
ship	S @ p
shipped	S @ p t
ships	S @ p s
shirburnians	S i b 3: n i@ n z
shocks	S Q k s
shooters	S u: t @ z
shooting	S u: t i N
shop	S Q p
short	S O: t
shortened	S O: t @ n d
shortly	S O: t l i
shorts	S O: t s
shot	S Q t
shotguns	S Q t g a n z
shout	S au t
showed	S @u d
showing	S @u i N
shows	S @u z
shugden	S a d @ n
shut	S a t
shuttle	S a t @ l
si	E s ai
siberian	s ai b i@ r\ i@ n
sid	s @ d
sides	s ai d z
siebold's	s ai b @u l d z
siemens	s i m @ n z
sierra	s i E r\ @
sight	s ai t
sigismund	s i d_0Z @ z m @ n d
sign	s ai n
signal	s i g n @ l
signature	s i g n @ tS @ r\
signed	s ai n d
significant	s i g n @ f i k @ n t
signing	s ai n i N
sikmogil	s i: k m @u d_0Z i l
silent	s ai l @ n t
silently	s ai l @ n t l i
silhouetted	s @ l U E t @ d
silos	s ai l @u z
silvio	s @ l v i@ @
similar	s @ m @ l @ r\
simon	s ai m @ n
simple	s @ m p @ l
simplification	s @ m p l i f i k @i S @ n
simulation	s @ m j U l @i S @ n
simultaneously	s @ m @ l t @i n i@ s l i
sina	s i: n @
since	s @ n s
sinclair	s @ n k l e@ r\
singer	s i N @ r\
singers	s i N @ z
singh	s i N
single	s i N g @ l
singles	s i N g @ l z
singular	s i N g j U l @ r\
sir	s 3: r\
sira	s i r\ @
sirius	s @ r\ i@ s
sister	s @ s t @ r\
sitcoms	s @ t k Q m z
site	s ai t
sites	s ai t s
sitting	s @ t i N
situation	s @ tS U @i S @ n
situational	s @ tS U @i S @ n @ l
situations	s @ tS U @i S @ n z
sixteenth	s i: k s t i: n T
sixth	s i k s T
sixtus	s i k s t @ s
size	s ai z
sized	s ai z d
sizing	s ai z i N
sk	E s k @i
skating	s k @i t i N
skeptics	s k E p t i k s
sketching	s k E tS i N
skies	s k ai z
skills	s k i l z
skin	s k i n
skinned	s k i n d
skirts	s k 3: t s
skit	s k i t
sky	s k ai
slam	s l { m
slander	s l A: n d @ r\
slashy	s l { S i
slave	s l @i v
slavery	s l @i v @ r\ i
slavic	s l { v i k
slavonic	s l @ v Q n i k
sledge	s l E d_0Z
slightly	s l ai t l i
slit	s l @ t
slobodan	s l @u b @ d @ n
slogan	s l @u g @ n
slogans	s l @u g @ n z
sloping	s l @u p i N
slovak	s l @u v { k
slovenian	s l @ v i: n i@ n
slow	s l @u
slowly	s l @u l i
slug	s l a g
small	s m O: l
smaller	s m O: l @ r\
smallpox	s m O: l p Q k s
smart	s m A: t
smirnov	s m 3: n Q f
smith	s m @ T
smithing	s m @ D i N
smithing	s m @ T i N
smithsonian	s m @ T s @u n i@ n
snack	s n { k
snake	s n @i k
snares	s n e@ z
sniper	s n ai p @ r\
snorkel	s n O: k @ l
snow	s n @u
so	s @u
soap	s @u p
soccer	s Q k @ r\
social	s @u S @ l
socialism	s @u S @ l @ z @ m
socialist	s @u S @ l @ s t
socialists	s @u S @ l @ s t s
socialites	s @u S @ l ai t s
societies	s @ s ai @ t i z
society	s @ s ai @ t i
sociocultural	s @u S i @u k a l tS @ r\ @ l
sockets	s Q k @ t s
soft	s Q f t
softball	s Q f t b O: l
software	s Q f t w e@ r\
solar	s @u l @ r\
sold	s @u l d
soldiers	s @u l d_0Z @ z
sole	s @u l
solemn	s Q l @ m
solid	s Q l @ d
solids	s Q l @ d z
solo	s @u l @u
solution	s @ l u: S @ n
solutions	s @ l u: S @ n z
solvable	s Q l v @ b @ l
solvents	s Q l v @ n t s
solving	s Q l v i N
somali	s U m A: l i
somalia	s U m A: l i@
some	s a m
somehow	s a m h\ au
somerset	s a m @ s @ t
somewhat	s a m w Q t
somoza	s @ m @u z @
son	s a n
song	s Q N
songs	s Q N z
sonic	s Q n i k
sonno	s Q n @u
soon	s u: n
sopra	s @u p r\ @
soprano	s U p r\ A: n @u
sort	s O: t
soteriology	s @u t i@ r\ i Q l @ d_0Z i
sought	s O: t
soul	s @u l
souls	s @u l z
sound	s au n d
sounds	s au n d z
source	s O: s
sourced	s O: s t
sources	s O: s @ s
south	s au T
southeast	s au T i: s t
southeastern	s au T i: s t @ n
southern	s a D @ n
southwest	s au T w E s t
southwestern	s au T w E s t @ n
sovereign	s Q v r\ @ n
soviet	s @u v i@ t
soweto	s U w E t @u
sox	s Q k s
sp	E s p i:
spa	s p A:
space	s p @i s
spacecraft	s p @i s k r\ A: f t
spaced	s p @i s t
spaceflight	s p @i s f l ai t
spaceflights	s p @i s f l ai t s
spaces	s p @i s @ s
spacious	s p @i S @ s
spades	s p @i d z
spain	s p @i n
spain's	s p @i n z
spanish	s p { n i S
spar	s p A: r\
sparta	s p A: t @
spartan	s p A: t @ n
speak	s p i: k
speaking	s p i: k i N
special	s p E S @ l
specialist	s p E S @ l @ s t
specialized	s p E S @ l ai z d
specializing	s p E S @ l ai z i N
specially	s p E S @ l i
specialties	s p E S @ l t i z
specialty	s p E S @ l t i
species	s p i: S i: z
specific	s p @ s @ f i k
specifically	s p @ s i f i k l i
specification	s p E s i f i k @i S @ n
specified	s p E s @ f ai d
specify	s p E s @ f ai
specifying	s p E s @ f ai i N
specimens	s p E s @ m @ n z
spectator	s p E k t @i t @ r\
spectroscopy	s p E k t r\ Q s k @ p i
spectrum	s p E k t r\ @ m
speculation	s p E k j U l @i S @ n
speed	s p i: d
speeds	s p i: d z
spell	s p E l
spellchecker	s p E l tS E k @ r\
spelling	s p E l i N
spencer	s p @ n s @ r\
spending	s p E n d i N
spent	s p E n t
spheres	s f i@ z
spherically	s f E r\ i k l i
spin	s p @ n
spinal	s p ai n @ l
spingarn	s p i N g A: n
spirit	s p @ r\ @ t
spirits	s p @ r\ @ t s
spiritual	s p i r\ i tS u@ l
spitz	s p @ t s
spla	E s p i: { l @i
split	s p l @ t
spoken	s p @u k @ n
sponsored	s p Q n s @ d
sport	s p O: t
sporting	s p O: t i N
sports	s p O: t s
sportspeople	s p O: t s p i: p @ l
spot	s p Q t
spots	s p Q t s
spottsylvania	s p Q t s @ l v @i n i@
sprang	s p r\ { N
spread	s p r\ E d
spring	s p r\ i N
springfield	s p r\ i N f i: l d
springs	s p r\ i N z
sprint	s p r\ @ n t
spruit	s p r\ u: t
sql	E s k j u: { l
squadron	s k w Q d r\ @ n
square	s k w e@ r\
squelched	s k w E l S t
sri	E s A: r\ ai
ss	E s E s
st	E s t i:
stability	s t @ b @ l @ t i
stable	s t @i b @ l
stadium	s t @i d i@ m
staff	s t A: f
stage	s t @i d_0Z
staged	s t @i d_0Z d
stagirites	s t { d_0Z @ r\ ai t s
stained	s t @i n d
stalinism	s t A: l @ n @ z @ m
stalling	s t O: l i N
stamp	s t { m p
stamps	s t { m p s
stan	s t { n
stand	s t { n d
standard	s t { n d @ d
standardizing	s t { n d @ d ai z i N
standards	s t { n d @ d z
standerton	s t { n d @ t @ n
stanford	s t { n f @ d
stanley	s t { n l i
star	s t A: r\
starostin	s t { r\ @ s t @ n
starring	s t A: r\ i N
stars	s t A: z
start	s t A: t
started	s t A: t @ d
startle	s t A: t @ l
starts	s t A: t s
starvation	s t A: v @i S @ n
stastistic	s t @ s t @ s t i k
state	s t @i t
state's	s t @i t s
stated	s t @i t @ d
stateless	s t @i t l @ s
statement	s t @i t m @ n t
states	s t @i t s
stating	s t @i t i N
station	s t @i S @ n
stationary	s t @i S @ n r\ i
stations	s t @i S @ n z
statistic	s t @ t i s t i k
statistical	s t @ t i s t i k @ l
statisticians	s t { t i s t i S @ n z
statistics	s t @ t i s t i k s
statistik	s t @ t @ s t i k
statuary	s t { tS u@ r\ i
status	s t @i t @ s
steam	s t i: m
steamed	s t i: m d
steaua	s t @u @
stedman	s t E d m @ n
steel	s t i: l
steering	s t i@ r\ i N
steffanie	s t E f @ n i
stein	s t i: n
stella	s t E l @
stellated	s t E @i t @ d
stellenbosch	s t E l @ n b @ S
stem	s t E m
stephen	s t i: v @ n
steppe	s t E p
stereotactic	s t E r\ i @u t { k t i k
sterling	s t 3: l i N
stern	s t 3: n
steve	s t i: v
stevenson	s t i: v @ n s @ n
stewart	s t j u: @ t
stig	s t i g
stitching	s t i tS i N
stock	s t Q k
stockhausen	s t Q k h\ au z @ n
stockholm	s t Q k h\ O: m
stockings	s t Q k i N z
stockton	s t Q k t @ n
stole	s t @u l
stone	s t @u n
stop	s t Q p
storage	s t O: r\ i d_0Z
stories	s t O: r\ i z
storm	s t O: m
story	s t O: r\ i
straight	s t r\ @i t
strands	s t r\ { n d z
strategic	s t r\ @ t i: d_0Z i k
strategies	s t r\ { t @ d_0Z i z
strategy	s t r\ { t @ d_0Z i
streak	s t r\ i: k
stream	s t r\ i: m
streams	s t r\ i: m z
street	s t r\ i: t
street's	s t r\ i: t s
streetcar	s t r\ i: t k A: r\
streisand	s t r\ ai s @ n d
strengthened	s t r\ E N T @ n d
stress	s t r\ E s
strife	s t r\ ai f
strike	s t r\ ai k
string	s t r\ i N
strip	s t r\ @ p
strips	s t r\ @ p s
stroke	s t r\ @u k
strokes	s t r\ @u k s
strong	s t r\ Q N
stronger	s t r\ Q N g @ r\
stronghold	s t r\ Q N h\ @u l d
strongman	s t r\ Q N m @ n
structural	s t r\ a k tS @ r\ @ l
structure	s t r\ a k tS @ r\
structured	s t r\ a k tS @ d
structures	s t r\ a k tS @ z
structuring	s t r\ a k tS @ r\ i N
stuart	s t j u: @ t
student	s t j u: d @ n t
students	s t j u: d @ n t s
studied	s t a d i d
studies	s t a d i z
studio	s t j u: d i@ @
studios	s t j u: d i@ U z
study	s t a d i
stuyvesant	s t ai v @ s @ n t
style	s t ai l
sub	s a b
subclass	s a b k l A: s
subcontractor	s a b k @ n t r\ { k t @ r\
subgroup	s a b g r\ u: p
subject	s a b d_0Z @ k t
subjects	s a b d_0Z @ k t s
sublimity	s @ b l @ m @ t i
submarine	s a b m @ r\ i: n
submarines	s a b m @ r\ i: n z
submit	s @ b m @ t
submitted	s @ b m @ t @ d
subprime	s @ p r\ ai m
subregions	s a b r\ i: d_0Z @ n z
subscriber	s @ b s k r\ ai b @ r\
subscription	s @ b s k r\ @ p S @ n
subsequent	s a b s @ k w @ n t
subset	s a b s E t
subsidiaries	s @ b s i d i@ r\ i z
subsidiary	s @ b s i d i@ r\ i
subsidies	s a b s @ d i z
subspecies	s a b s p i: S i: z
substance	s a b s t @ n s
substances	s a b s t @ n s @ s
substitute	s a b s t i t j u: t
substituting	s a b s t i t j u: t i N
substrate	s a b s t r\ @i t
subtext	s a b t E k s t
subtropical	s a b t r\ Q p i k @ l
suburban	s @ b 3: b @ n
subversive	s a b v 3: s @ v
subway	s a b w @i
success	s @ k s E s
successful	s @ k s E s f @ l
successfully	s @ k s E s f @ l i
succession	s @ k s E S @ n
successor	s @ k s E s @ r\
sudan	s u: d A: n
sudanese	s u: d @ n i: z
suddenly	s a d n l i
suffered	s a f @ d
suffix	s a f i k s
suffolk	s a f @ k
suffrage	s a f r\ i d_0Z
sugar	S U g @ r\
suggested	s @ d_0Z E s t @ d
suggesting	s @ d_0Z E s t i N
suggests	s @ d_0Z E s t s
suicide	s j u: @ s ai d
suicides	s j u: @ s ai d z
suit	s u: t
suite	s w i: t
sulfate	s a l f @i t
sulfur	s a l f 3: r\
sulfuric	s a l f j U r\ i k
sulla	s a l @
sulla	s U l @
sultan	s a l t @ n
sum	s a m
sumerian	s j u: m i@ r\ i@ n
summarize	s a m @ r\ ai z
summarizes	s a m @ r\ ai z @ z
summer	s a m @ r\
summit	s a m @ t
sun	s a n
sundance	s a n d @ n s
sunday	s a n d @i
sunningdale	s a n i N d @i l
sunnyside	s a n i s ai d
sunroof	s a n r\ u: f
super	s u: p @ r\
supercharger's	s u: p @ tS A: d_0Z @ r\ z
superiority	s u: p i@ r\ i Q r\ @ t i
supermassive	s u: p @ m { s @ v
supernovae	s u: p @ n @ v i
supervenient	s u: p @ v i: n i@ n t
supplement	s a p l @ m @ n t
supplementary	s a p l i m E n t r\ i
suppliers	s @ p l ai @ z
supply	s @ p l ai
support	s @ p O: t
supported	s @ p O: t @ d
supporting	s @ p O: t i N
supposed	s @ p @u z d
supposedly	s @ p @u z @ d l i
supreme	s u: p r\ i: m
surface	s 3: f @ s
surfaced	s 3: f @ s t
surgery	s 3: d_0Z @ r\ i
surgical	s 3: d_0Z i k @ l
suri	s u: r\ i
surpass	s @ p A: s
surplus	s 3: p l @ s
surrounded	s @ r\ au n d @ d
surrounding	s @ r\ au n d i N
surveillance	s 3: v @i l @ n s
survey	s 3: v @i
surveys	s 3: v @i z
survivors	s @ v ai v @ z
susan	s u: z @ n
suspension	s @ s p E n S @ n
sustainable	s @ s t @i n @ b @ l
sutin	s u: t @ n
sutras	s U t r\ @ z
suu	E s j u: j u:
suzerainty	s u: z @ r\ @ n t i
suzuki	s U z u: k i
swanville	s w Q n v @ l
swaying	s w @i i N
swaziland	s w A: z i l { n d
sweden	s w i: d @ n
swedish	s w i: d i S
sweeping	s w i: p i N
swet	s w E t
swift	s w @ f t
swiftly	s w @ f t l i
swilly	s w i l i
swimming	s w i m i N
swing	s w i N
swiss	s w @ s
switched	s w i tS t
switching	s w i tS i N
switzerland	s w @ t s @ l @ n d
swords	s O: d z
sydney	s @ d n i
syenite	s ai @ n ai t
symbol	s @ m b @ l
symbolic	s @ m b Q l i k
symbols	s @ m b @ l z
symmetric	s @ m E t r\ i k
symphonic	s @ m f Q n i k
symphony	s @ m f @ n i
symphony's	s @ m f @ n i z
synagogue	s @ n @ g Q g
synchronous	s @ n k r\ @ n @ s
syndicate	s @ n d i k @ t
syndicated	s @ n d i k @i t @ d
syndrome	s @ n d r\ @u m
synodic	s @ n Q d i k
synopses	s @ n Q p s i: z
synoptic	s @ n Q p t i k
syntax	s @ n t { k s
synthesis	s @ n T @ s @ s
synthesizer	s @ n T @ s ai z @ r\
synthetic	s @ n T E t i k
syria	s @ r\ i@
syriac	s @ r\ i { k
system	s @ s t @ m
systematically	s @ s t @ m { t i k l i
systems	s @ s t @ m z
t	t i:
table	t @i b @ l
taciturn	t { s i t 3: n
tacitus	t { s i t @ s
tactical	t { k t i k @ l
taft	t a f t
tai	t ai
taika	t ai k @
tailor	t @i l @ r\
taim	t @i m
taken	t @i k @ n
takeoff	t @i k Q f
takes	t @i k s
taking	t @i k i N
tales	t @i l z
talk	t O: k
talks	t O: k s
taller	t O: l @ r\
talus	t @i l @ s
tamil	t { m @ l
tampa	t { m p @
tanah	t { n @
tang	t { N
tanhuma	t { n h\ j u: m @
tank	t { N k
tanks	t { N k s
tanzania	t { n z @ n i@
tao	t au
tape	t @i p
taref	t { r\ E f
tariff	t { r\ @ f
tarnishes	t A: n i S @ z
tarzan	t A: z { n
task	t A: s k
taught	t O: t
tavistock	t { v @ s t Q k
tavola	t { v @u l @
tax	t { k s
taxation	t { k s @i S @ n
taxes	t { k s @ s
taya	t ai j @
taylor	t @i l @ r\
tayseer	t @i s i@ r\
tchaikovsky's	tS ai k Q f s k i z
te	t i: i:
teaches	t i: tS @ z
teaching	t i: tS i N
team	t i: m
teams	t i: m z
tears	t i@ z
technical	t E k n i k @ l
techniques	t E k n i: k s
technologically	t E k n @ l Q d_0Z i k l i
technologies	t E k n Q l @ d_0Z i z
technology	t E k n Q l @ d_0Z i
ted	t E d
teenage	t i: n @i d_0Z
telecommunication	t E l @ k @ m j u: n i k @i S @ n
telecommunications	t E l @ k @ m j u: n i k @i S @ n z
telephone	t E l i f @u n
telescope	t E l i s k @u p
teletype	t E l @ t ai p
television	t E l i v i Z @ n
tell	t E l
tembisa	t E m b i: s @
temperament	t E m p r\ @ m @ n t
temperature	t E m p r\ @ tS 3:
temperature	t E m p r\ @ tS @ r\
temperatures	t E m p r\ @ tS 3: z
temperatures	t E m p r\ @ tS @ z
temperaturess	t E m p r\ @ tS @ r\ E s
templates	t E m p l @ t s
temple	t E m p @ l
templeton	t E m p @ l t @ n
templi	t E m p l i
templi	t E m p l @i
tempore	t E m p O: r\
tempus	t E m p @ s
tends	t E n d z
tenji	t E n d_0Z i
tenji's	t E n d_0Z i z
tennessee	t E n @ s i
tennis	t E n @ s
tense	t E n s
tensions	t E n S @ n z
tensor	t E n s @ r\
term	t 3: m
terminology	t 3: m i n Q l @ d_0Z i
terms	t 3: m z
terrestrial	t i r\ E s t r\ i@ l
territorial	t E r\ i t O: r\ i@ l
territories	t E r\ i t r\ i z
territory	t E r\ i t r\ i
terrorism	t E r\ @ r\ @ z @ m
terrorist	t E r\ @ r\ @ s t
terry	t E r\ i
terry's	t E r\ i z
tertiary	t 3: S @ r\ i
test	t E s t
testament	t E s t @ m @ n t
testing	t E s t i N
tests	t E s t s
teutonic	t j u: t Q n i k
tewahedo	t w @ h\ i: d @u
texas	t E k s @ s
text	t E k s t
textbooks	t E k s b U k s
texts	t E k s t s
than	D { n
that	D { t
thatcher	T { tS @ r\
the	D @
theater	T i@ t 3:
theatre	T i@ t @ r\
thee	D i
theft	T E f t
their	D e@ r\
thekla	T E k l @
thelemites	T E l @ m ai t s
themes	T i: m z
then	D E n
thence	D E n s
theodor	T i@ d O: r\
theodore	T i@ d O: r\
theodosius	T i@ d @u s i@ s
theologians	T i@ l @u d_0Z @ n z
theological	T i@ l Q d_0Z i k @ l
theology	T i Q l @ d_0Z i
theorem	T i@ r\ @ m
theorems	T i@ r\ @ m z
theoretical	T i@ r\ E t i k @ l
theories	T i@ r\ i z
theorists	T i@ r\ @ s t s
theorized	T i@ r\ ai z d
theory	T i@ r\ i
therapies	T E r\ @ p i z
therapy	T E r\ @ p i
theravada	T E r\ @ v A: d @
there	D e@ r\
thermal	T 3: m @ l
thermidor	T 3: m @ d O: r\
thermodynamic	T 3: m @u d ai n { m i k
thermodynamics	T 3: m @u d ai n { m i k s
thermoelectric	T 3: m @u i l E k t r\ i k
thesis	T i: s @ s
thessalian	T E s @i l i@ n
theunissen	t i@ n @ s @ n
thickness	T i k n @ s
thine	D ai n
things	T i N z
thinkers	T i N k @ z
thinking	T i N k i N
third	T 3: d
thirteen	T 3: t i: n
thirty	T 3: t i
this	D @ s
thomas	t Q m @ s
thoreau	T @ r\ i: @
thorpe	T O: p
those	D @u z
thought	T O: t
thousand	T au z @ n d
thrace	T r\ @i s
thread	T r\ E d
threatened	T r\ E t @ n d
threats	T r\ E t s
throat	T r\ @u t
throb	T r\ Q b
through	T r\ u:
thumb	T a m
thy	D ai
ti	t i:
tibetan	t i b E t @ n
tidal	t ai d @ l
tierra	t i@ r\ @
ties	t ai z
till	t @ l
time	t ai m
timelines	t ai m l ai n z
times	t ai m z
timing	t ai m i N
tin	t @ n
tiny	t ai n i
tiptree	t @ p t r\ i
tiraz	t ai r\ @i z
tisha	t i S @
tissue	t i S u:
titanium	t ai t @i n i@ m
tite	t ai t
titicaca	t @ t i k A: k @
title	t ai t @ l
titled	t ai t @ l d
titles	t ai t @ l z
tito	t i: t @u
tmo	t i: E m @u
to	t u:
tobacco	t @ b { k @u
tocharian	t @u k { r\ i@ n
today	t @ d @i
today's	t @ d @i z
todorov	t @u d @ r\ Q f
toffler	t Q f l @ r\
toils	t Oi l z
toku	t @u k u:
tokyo	t @u k i @u
told	t @u l d
toll	t @u l
tom	t Q m
tomography	t @ m Q g r\ @ f i
tonbridgians	t Q n b r\ i d_0Z @ n z
tone	t @u n
tones	t @u n z
tong	t Q N
tons	t a n z
tony	t @u n i
took	t U k
tool	t u: l
tools	t u: l z
topological	t Q p @ l Q d_0Z i k @ l
torah	t O: r\ @
toronto	t @ r\ Q n t @u
torquay	t O: k i:
tory	t O: r\ i
total	t @u t @ l
totally	t @u t @ l i
tottenham	t Q t @ n @ m
tour	t u@ r\
touring	t u@ r\ i N
tourism	t u@ r\ @ z @ m
tourist	t u@ r\ @ s t
tourists	t u@ r\ @ s t s
tournament	t O: n @ m @ n t
tower	t au @ r\
town	t au n
towns	t au n z
township	t au n S @ p
toy	t Oi
tr	t i: A: r\
trace	t r\ @i s
traces	t r\ @i s @ s
tracing	t r\ @i s i N
track	t r\ { k
tracking	t r\ { k i N
tracks	t r\ { k s
trade	t r\ @i d
traded	t r\ @i d @ d
trader	t r\ @i d @ r\
trading	t r\ @i d i N
tradition	t r\ @ d i S @ n
traditional	t r\ @ d i S @ n @ l
traditionally	t r\ @ d i S @ n @ l i
traditions	t r\ @ d i S @ n z
traffic	t r\ { f i k
tragic	t r\ { d_0Z i k
tragica	t r\ { d_0Z i k @
traian	t r\ @i @ n
trail	t r\ @i l
train	t r\ @i n
trained	t r\ @i n d
training	t r\ @i n i N
trains	t r\ @i n z
tram	t r\ { m
trams	t r\ { m z
trans	t r\ { n z
transaction	t r\ { n z { k S @ n
transcendentalism	t r\ { n s E n d E n t @ l @ z @ m
transduction	t r\ { n s d a k S @ n
transfer	t r\ { n s f 3: r\
transferable	t r\ { n s f 3: r\ @ b @ l
transfersome	t r\ { n s f 3: s @ m
transform	t r\ { n s f O: m
transformations	t r\ { n s f @ m @i S @ n z
transit	t r\ { n s @ t
transition	t r\ { n z i S @ n
transitional	t r\ { n s i S @ n @ l
translation	t r\ { n s l @i S @ n
translations	t r\ { n s l @i S @ n z
transmission	t r\ { n z m i S @ n
transmitted	t r\ { n z m @ t @ d
transmitter	t r\ { n z m @ t @ r\
transmitting	t r\ { n z m @ t i N
transplanting	t r\ { n s p l A: n t i N
transport	t r\ { n s p O: t
transportation	t r\ { n s p O: t @i S @ n
transylvania	t r\ { n s @ l v @i n i@
trapezoidal	t r\ { p @ z Oi d @ l
traps	t r\ { p s
traumatic	t r\ O: m { t i k
travel	t r\ { v @ l
traveled	t r\ { v @ l d
traveling	t r\ { v l i N
treasury	t r\ E Z @ r\ i
treaties	t r\ i: t i z
treatment	t r\ i: t m @ n t
treatments	t r\ i: t m @ n t s
treaty	t r\ i: t i
tree	t r\ i
trees	t r\ i: z
trek	t r\ E k
trenches	t r\ E n tS @ z
trial	t r\ ai @ l
trials	t r\ ai @ l z
tribal	t r\ ai b @ l
tribes	t r\ ai b z
tribunal	t r\ ai b j u: n @ l
tribune	t r\ @ b j u: n
tricycle	t r\ ai s i k @ l
tried	t r\ ai d
trier	t r\ ai @ r\
triggering	t r\ i g @ r\ i N
trilby	t r\ @ l b i
trinity	t r\ i n i t i
triphosphate	t r\ ai f Q s f @i t
triple	t r\ @ p @ l
triplet	t r\ @ p l @ t
tripoli	t r\ ai p Q l i
triprotic	t r\ @ p r\ Q t i k
trips	t r\ @ p s
tristan	t r\ @ s t @ n
triumphal	t r\ ai a m f @ l
triumphed	t r\ ai @ m f t
trivial	t r\ i v i@ l
trojan	t r\ @u d_0Z @ n
troops	t r\ u: p s
troost	t r\ u: s t
trophies	t r\ @u f i z
tropical	t r\ Q p i k @ l
troyer	t r\ Oi @ r\
truck	t r\ a k
true	t r\ u:
truly	t r\ u: l i
truman	t r\ u: m @ n
trust	t r\ a s t
trusteeship	t r\ a s t i: S @ p
truths	t r\ u: T s
tsar	z A: r\
tt	t i: t i:
tua	t u@
tuareg	t u@ r\ E g
tubby	t a b i
tube	t j u: b
tuberculosis	t j u: b 3: k j U l @u s @ s
tubes	t j u: b z
tuchman	t U tS m @ n
tuition	t j u: i S @ n
tuition	t U i S @ n
tulcea	t a l s i@
tungsten	t a N s t @ n
tunisia	t j u: n @ z i@
tunisia	t u: n i z i@
tunnel	t a n @ l
tunneling	t a n l i N
turbine	t 3: b ai n
turbo	t 3: b @u
turing	t j U r\ i N
turkey	t 3: k i
turkic	t 3: k i k
turkish	t 3: k i S
turks	t 3: k s
turned	t 3: n d
turner	t 3: n @ r\
turning	t 3: n i N
turnpike	t 3: n p ai k
turtles	t 3: t @ l z
tutoring	t j u: t @ r\ i N
tv	t i: v i:
twelve	t w E l v
twentieth	t w E n t i@ T
twenty	t w E n t i
twice	t w ai s
two	t u:
tycoon	t ai k u: n
type	t ai p
types	t ai p s
typhus	t ai f @ s
typical	t i p i k @ l
typically	t i p i k l i
u	j u:
uefa	j E @i f @
uefa	j u: i: E f @i
uk	j u: k @i
ukrainian	j u: k r\ @i n i @ n
ulam	j u: l @ m
ulansey	j u: l { n s i
ulm	j u: { l E m
ulm	u: l m
ulster	a l s t @ r\
ultimately	a l t @ m @ t l i
ulysses	a u: l i s @ s
um	j u: E m
unauthorized	a n O: T @ r\ ai z d
unbroken	a n b r\ @u k @ n
unbundling	a n b a n d l i N
uncapped	a n k { p t
uncertainty	a n s 3: t @ n t i
unchanged	a n tS @i n d_0Z d
unconventional	a n k @ n v E n S @ n @ l
und	a n d
under	a n d @ r\
undercarriage	a n d @ k { r\ i d_0Z
undergoes	a n d @ g @u z
undergraduate	a n d @ g r\ { d_0Z u@ t
underground	a n d @ g r\ au n d
understandably	a n d @ s t { n d @ b l i
understanding	a n d @ s t { n d i N
underutilized	a n d @ r\ j u: t @ l ai z d
underwent	a n d @ w E n t
undimmed	a n d @ m d
unemployment	a n @ m p l Oi m @ n t
unequal	a n i: k w @ l
unesco	j u: n E s k @u
unexpectedly	a n @ k s p E k t @ d l i
unfccc	j u: E n E f s i: s i: s i:
unicameral	j u: n i k { m @ r\ @ l
unicode	j u: n i k @u d
unification	j u: n i f i k @i S @ n
unified	j u: n @ f ai d
uniform	j u: n i f O: m
unilateral	j u: n i l { t r\ @ l
uninhabited	a n i n h\ { b @ t @ d
union	j u: n i@ n
union's	j u: n i@ n z
unionist	j u: n i@ n @ s t
unions	j u: n i@ n z
unique	j u: n i: k
unit	j u: n @ t
unita	j u: n i: t @
unitarians	j u: n i t e@ r\ i@ n z
united	j u: n ai t @ d
units	j u: n @ t s
unity	j u: n @ t i
universal	j u: n i v 3: s @ l
universe	j u: n i v 3: s
universities	j u: n i v 3: s @ t i z
university	j u: n i v 3: s @ t i
unix	j u: n i k s
unless	@ n l E s
unlike	a n l ai k
unmanned	a n m { n d
unnatural	a n n { tS r\ @ l
unnecessary	a n n E s @ s r\ i
unpopular	a n p Q p j U l @ r\
unprofitable	a n p r\ Q f @ t @ b @ l
unpublished	a n p a b l i S t
unrecognized	a n r\ E k @ g n ai z d
unreleased	a n r\ @ l i: s t
unreliable	a n r\ @ l ai @ b @ l
unrestricted	a n r\ @ s t r\ i k t @ d
unsaturated	a n s { tS @ r\ @i t @ d
unter	a n t @ r\
unused	a n j u: s t
updated	a p d @i t @ d
upgrades	a p g r\ @i d z
upheavals	a p h\ i: v @ l z
upheld	a p h\ E l d
upper	a p @ r\
upright	a p r\ ai t
uprising	a p r\ ai z i N
upscale	a p s k @i l
upstate	a p s t @i t
uralic	j U r\ { l i k
uranium	j U r\ @i n i@ m
urban	3: b @ n
urbe	3: b
url	j u: A: r\ { l
us	a s
usa	j u: E s @i
usage	j u: s i d_0Z
usaid	j u: E s @i ai d i:
usaid	j u: E s @i d
usculture	j u: E s k a l tS 3:
use	j u: s
used	j u: s t
useful	j u: s f @ l
usenet	j u: s E n @ t
user	j u: z @ r\
user's	j u: z @ r\ z
users	j u: z @ z
uses	j u: s @ s
usinfo	j u: z @ n f @u
using	j u: z i N
usk	j u: E s k @i
uss	j u: E s E s
usually	j u: Z @ l i
usum	j u: s @ m
usurper	j u: z 3: p @ r\
utah	j u: t a
utari	j u: t A: r\ i
utc	j u: t i: s i:
uterine	j u: t @ r\ i: n
utilise	j u: t @ l ai z
utilities	j u: t @ l @ t i z
utility	j u: t @ l @ t i
utopian	j u: t @u p i@ n
v	v i:
vacations	v @ k @i S @ n z
vacuum	v { k j u@ m
vale	v @i l
valence	v { l @ n s
valhalla	v { l h\ { l @
valley	v { l i
valleys	v { l i z
valuable	v { l j u@ b @ l
value	v { l j u:
valued	v { l j u: d
valve	v { l v
van	v { n
vanderbilt	v { n d @ b @ l t
vanguard	v { n g A: d
vanity	v { n @ t i
vapor	v @i p @ r\
variable	v e@ r\ i@ b @ l
variables	v e@ r\ i@ b @ l z
variance	v e@ r\ i@ n s
variants	v e@ r\ i@ n t s
variations	v e@ r\ i @i S @ n z
varieties	v @ r\ ai @ t i z
variety	v @ r\ ai @ t i
various	v e@ r\ i@ s
vary	v e@ r\ i
vasopressin	v { s @ p r\ E s @ n
vast	v A: s t
vastly	v A: s t l i
vatican	v { t i k @ n
vaughan	v O: n
vector	v E k t @ r\
vegas	v @i g @ s
vegetables	v E d_0Z @ t @ b @ l z
vegetarians	v E d_0Z @ t e@ r\ i@ n z
vehicle	v i: i k @ l
vehicles	v i: i k @ l z
velocity	v @ l Q s @ t i
velvet	v E l v @ t
venezuelan	v E n @ z w @i l @ n
venice	v E n @ s
venture	v E n tS @ r\
ventured	v E n tS @ d
verb	v 3: b
verde	v 3: d
verifiable	v E r\ @ f ai @ b @ l
verification	v E r\ i f i k @i S @ n
verify	v E r\ @ f ai
vernacular	v @ n { k j U l @ r\
verne	v n
versailles	v 3: s ai
version	v 3: S @ n
versions	v 3: S @ n z
versus	v 3: s @ s
vertebrate	v 3: t @ b r\ @i t
vertex	v 3: t E k s
vertical	v 3: t i k @ l
vertices	v 3: t @ s i: z
vesa	v i: s @
vesicles	v E s i k @ l z
vessel	v E s @ l
vested	v E s t @ d
veteran	v E t @ r\ @ n
veterans	v E t @ r\ @ n z
vic	v i k
vice	v ai s
viceroys	v ai s r\ Oi z
vicksburg	v i k s b 3: g
victims	v i k t @ m z
victor	v i k t @ r\
victoria	v i k t O: r\ i@
victorian	v i k t O: r\ i@ n
victories	v i k t @ r\ i z
video	v i d i@ @
videos	v i d i@ U z
vietnam	v i E t n A: m
vietnamese	v i E t n @ m i: z
view	v j u:
viewpoints	v j u: p Oi n t s
viking	v ai k i N
village	v i l i d_0Z
villages	v i l i d_0Z @ z
ville	v @ l
vilnius	v @ l n i@ s
vincent	v @ n s @ n t
vinyl	v ai n @ l
violations	v ai @ l @i S @ n z
violin	v ai @ l @ n
violinists	v ai @ l @ n @ s t s
vipsanius	v @ p s @i n i@ s
virgin	v 3: d_0Z @ n
virginia	v @ d_0Z i n i@
virtual	v 3: tS u@ l
virulence	v @ r\ @ l @ n s
virus	v ai @ r\ @ s
virus	v ai r\ @ s
visa	v i: z @
visible	v @ z @ b @ l
visigoths	v @ s i g Q T s
vision	v i Z @ n
visionary	v i Z @ n r\ i
visited	v @ z @ t @ d
visitor	v @ z @ t @ r\
visitors	v @ z @ t @ z
visual	v i Z u@ l
vita	v @ t @
vital	v ai t @ l
vivo	v i v @u
vizier	v @ z i@ r\
vla	v i: E l @i
vla	v l a
vladimir	v l { d i m i@ r\
vocal	v @u k @ l
vocs	v i: @u s i: E s
vocs	v Q k s
voice	v Oi s
voip	v Oi p
voivodeship	v Oi v @u d S @ p
volatile	v Q l @ t ai l
volcanic	v Q l k { n i k
volt	v Q l t
volunteer	v Q l @ n t i@ r\
volunteers	v Q l @ n t i@ z
von	v Q n
voronoy	v Q r\ @ n Oi
vote	v @u t
voted	v @u t @ d
votes	v @u t s
voting	v @u t i N
vowel	v au @ l
vowels	v au @ l z
vs	v 3: s @ s
vs	v i: E s
vulgar	v a l g @ r\
waals	w A: l z
wadsworth	w a d z w @ T
wage	w @i d_0Z
wagers	w @i d_0Z @ z
waldo	w { l d @u
wales	w @i l z
walhalla	w a l h\ a l @
walker	w O: k @ r\
wall	w O: l
wallace	w Q l @ s
walles	w Q l z
walt	w Q l t
walter	w Q l t @ r\
wanda	w Q n d @
wantage	w Q n t i d_0Z
war	w O: r\
warfare	w O: f e@ r\
warhola	w O: h\ @u l @
warned	w O: n d
warner	w O: n @ r\
warning	w O: n i N
warren's	w Q r\ @ n z
warring	w O: r\ i N
wars	w O: z
warsaw	w O: s O:
wartime	w O: t ai m
warwickshire	w Q r\ i k S @ r\
was	w Q z
washington	w Q S i N t @ n
wasn	w A: z @ n
wastes	w @i s t s
watch	w Q tS
water	w O: t @ r\
waterproof	w O: t @ p r\ u: f
watershed	w O: t @ S E d
waterway	w O: t @ w @i
watson	w Q t s @ n
wave	w @i v
waves	w @i v z
way	w @i
wayne	w @i n
we	w i:
weak	w i: k
weaknesses	w i: k n @ s @ s
weapons	w E p @ n z
wearing	w e@ r\ i N
weather	w E D @ r\
web	w E b
weber	w i: b @ r\
website	w E b s ai t
websites	w E b s ai t s
wedding	w E d i N
weekend	w i: k E n d
weekly	w i: k l i
weight	w @i t
weighted	w @i t @ d
welding	w E l d i N
welham	w E l h\ @ m
welles	w E l z
wendell	w E n d E l
went	w E n t
wer	d a b @ l j u: i: A: r\
were	w 3: r\
wernher	w 3: n @ r\
werth	w 3: T
wesleyan	w E z l i@ n
wessels	w E s @ l z
west	w E s t
western	w E s t @ n
westminster	w E s t m @ n s t @ r\
westminsters	w E s t m @ n s t @ z
westmister	w E s t m @ s t @ r\
westwood	w E s t w U d
weyden	w @i d @ n
wfaa	d a b @ l j u: E f @i @i
whales	w @i l z
whaling	w @i l i N
wheel	w i: l
wheeled	w i: l d
when	w E n
whence	w E n s
which	w i tS
whig	w i g
while	w ai l
whilst	w ai l s t
whirlpool	w 3: l p u: l
whit	w @ t
white	w ai t
whitehead	w ai t h\ E d
whitehead's	w ai t h\ E d z
whitehouse	w ai t h\ au s
whitespace	w ai t s p @i s
whitfield	w @ t f i: l d
whitford's	w @ t f @ d s
who	h\ u:
wholly	h\ @u l i
wholly	h\ @u l l i
whose	h\ u: z
wide	w ai d
widely	w ai d l i
widespread	w ai d s p r\ E d
widow	w i d @u
wiggin	w i g @ n
wiki	w i k i
wikipedia	w i k i p i: d i@
wilbur	w @ l b 3: r\
wild	w ai l d
wilderness	w @ l d @ n @ s
wildlife	w ai l d l ai f
wiley	w i l i
wilhelm	v @ l h\ E l @ m
wilhelm	w @ l h\ E l @ m
wilkes	w @ l k s
wilkinson	w @ l k i n s @ n
will	w @ l
willamette	w @ l @ m E t
william	w @ l i@ m
williams	w @ l i@ m z
willing	w i l i N
willing	w @ l i N
willows	w @ l @u z
wilmington	w @ l m i N t @ n
wilmslow	w @ l m z l @u
wilson	w i l s @ n
wimbledon	w @ m b @ l d @ n
wimsey	w @ m z i
win	w @ n
windows	w i n d @u z
windows	w @ n d @u z
winds	w ai n d z
winds	w i n d z
windshield	w i n d S i: l d
wing	w i N
wings	w i N z
winner	w @ n @ r\
winners	w @ n @ z
winning	w @ n i N
winston	w @ n s t @ n
winter	w @ n t @ r\
wipers	w ai p @ z
wipo	w ai p @u
wir	d a b @ l j u: ai A: r\
wir	w i@ r\
wireless	w ai @ l @ s
wisconsin	w @ s k Q n s @ n
wisdom	w @ z d @ m
wishes	w i S @ z
witbank	v @ t b a N k
witbank	w @ t b { N k
witch	w i tS
with	w @ D
withdrew	w @ D d r\ u:
witnessed	w @ t n @ s t
witts	w @ t s
wiyas	w ai j @ z
wolf	w U l f
wolfville	w U l f v @ l
women	w @ m @ n
women's	w @ m E n z
won	w a n
wondrous	w a n d r\ @ s
wood	w U d
woodrow	w U d r\ @u
worcester	w U s t @ r\
word	w 3: d
words	w 3: d z
work	w 3: k
worker	w 3: k @ r\
workers	w 3: k @ z
working	w 3: k i N
works	w 3: k s
workshop	w 3: k S Q p
workstation	w 3: k s t @i S @ n
world	w 3: l d
worldcon	w 3: l d k @ n
worldwide	w 3: l d w ai d
worn	w O: n
worse	w 3: s
worth	w 3: T
would	w U d
wpcus	d a b @ l j u: p i: s i: j u: E s
wretch	r\ E tS
wright	r\ ai t
write	r\ ai t
writer	r\ ai t @ r\
writers	r\ ai t @ z
writes	r\ ai t s
writing	r\ ai t i N
writings	r\ ai t i N z
written	r\ @ t @ n
wrote	r\ @u t
wta	d a b @ l j u: t i: @i
wycliffe	w ai k l @ f
wynberg	v @i n b 3: g
wynberg	v @i n b E r\ k
wyoming	w ai @u m i N
x	E k s
xi	E k s ai
xiaoping	S au p i N
xliv	E k s E l ai v i:
xliv	E k s l @ v
xm	E k s E m
xml	E k s E m { l
y	w ai
yale	j @i l
yamaha	j A: m @ h\ A:
yangtze	j { N t s @
yankee	j { N k i
yankees	j { N k i z
yard	j A: d
yayoi	j a j Oi
year	j 3: r\
yearned	j 3: n d
years	j 3: z
yeats	j @i t s
yellowstone	j E l @u s t @u n
yeltsin	j E l t s @ n
yemen	j E m @ n
yes	j E s
yew	j u:
yields	j i: l d z
yitzhak	j @ t s @i k
yogic	j @u g i k
york	j O: k
yorker	j O: k @ r\
young	j a N
younger	j a N g @ r\
yousaf	j U s @ f
youth	j u: T
yuan	j U A: n
yugoslavia	j u: g @ s l A: v i@
yvonne	i v Q n
zambia	z { m b i@
zander	z { n d @ r\
zealand	z i: l @ n d
zelikow	z E l i k @u
zen	z E n
zeppelins	z E p @ l @ n z
zermelo	z @ m E l @u
zero	z i@ r\ @u
zeta	z i: t @
zeus	z i@ s
zf	z E t E f
zf	z i: E f
zimbabwe	z @ m b a b w E
zimmermann	z @ m @ m @ n
zinka	z i N k @
zionist	z ai @ n @ s t
zone	z @u n
zones	z @u n z
zoologists	z u: Q l @ d_0Z @ s t s
zosimus	z @u s @ m @ s
zubaydah	z U b ai d @
zulfikar	z a l f i k @ r\
zurich	z j u@ r\ i k
zx	z E t E k s
zx	z i: E k s
