a	E
aa	a
aba	a b a
abela	a b E l a
abelanwang	a b E l a n w a N
abelwa	a b E l w a
abelwang	a b E l w a N
abetswe	a b E ts_> w E
abetsweng	a b E ts_> w E N
abilweng	a b i l w E N
abiwa	a b i w a
abiwang	a b i w a N
abram	a b r a m
abram	E b r a m
absa	a b a
abuti	a b u t_> i
academy	E k_h a d E m i
act	a k_h t_h
action	a k_h s E n
adam	a d a m
adam	a d E m
adikgang	a d i kx a N
adilweng	a d i l w E N
adipuo	a d i p_> u O
afe	a f E
aferika	a f E r i k_> a
afidafiti	a f i d a f i t_> i
afitafiti	a f i t_> a f i t_> i
afoprika	a f O p_> r i k_> a
aforika	a f O r i k_> a
africa	a f r i k_h E
african	a f r i k_h E n
afrika	a f r i k_> a
aga	a x a
age	a x E
age	E d_0Z
agegileng	a x E x i l E N
agelela	a x E l E l a
agelelang	a x E l E l a N
agelelwa	a x E l E l w a
agelwa	a x E l w a
agency	E d_0Z E n s i
ageng	a x E N
agileng	a x i l E N
ago	a x O
ago	E k_> O
agoa	a x O a
agoa	E k_> O a
agri	a x r i
agriculture	a k_> r i k_h a l tS_h E r
aids	a i d
aids	E d s
air	a i r
air	E r
akanya	a k_> a J a
akanyang	a k_> a J a N
akarediwa	a k_> a r E d i w a
akaretsa	a k_> a r E ts_> a
akaretsang	a k_> a r E ts_> a N
akaretse	a k_> a r E ts_> E
ake	a k_> E
akgola	a kx O l a
akhaonteng	a k_h a O n t_> E N
akhaonto	a k_h a O n t_> O
akhaontong	a k_h a O n t_> O N
alacrity	E l a k_h r i t_h i
alafelwa	a l a f E l w a
aldrin	a l d r E n
aldrin	a l d r i n
all	a l l
all	O l
allemansdrift	a l E m a n s d r E f t_h
allemansdrift	a l l E m a n s d r i f t_>
ama	a m a
amanang	a m a n a N
amang	a m a N
amegang	a m E x a N
america	E m E r i k_h E
american	E m E r i k_h E n
amerika	a m E r i k_> a
amileng	a m i l E N
amilweng	a m i l w E N
amiwang	a m i w a N
ammotsa	a m m O ts_> a
amogela	a m O x E l a
amogelang	a m O x E l a N
amogele	a m O x E l E
amogelegang	a m O x E l E x a N
amogelesegang	a m O x E l E s E x a N
amogelesegile	a m O x E l E s E x i l E
amogelwa	a m O x E l w a
amogelwang	a m O x E l w a N
amogelwe	a m O x E l w E
amogetse	a m O x E ts_> E
amogetswe	a m O x E ts_> w E
amogetsweng	a m O x E ts_> w E N
amogilweng	a m O x i l w E N
anaanela	a n a n E l a
anama	a n a m a
anamang	a n a m a N
anamisa	a n a m i s a
ancestor	a n s E s t_h E r
aneelemots	a n E E l E m O ts_>
anela	a n E l a
angeles	a n d_0Z E l i s
angeles	a N x E l E s
animated	a n E m E t_h E d
animated	a n i m a t_> E d
anna	a n E
anna	a n n a
ano	a n O
anya	a J a
anyisiwa	a J i s i w a
ao	a O
aorika	a O r i k_> a
aotha	a O t_h a
ap	a p_>
apare	a p_> a r E
apaya	a p_> a j a
ape	a p_> E
ape	E p_h
apeela	a p_> E E l a
apeye	a p_> E j E
apo	a p_> O
apostolic	a p_h E s t_h O l i k_h
appointed	a p_> p_> O i n t_> E d
appointed	E p_h O n t_h E d
arab	a r a b
arab	a r E b
araba	a r a b a
arabe	a r a b E
arabiwa	a r a b i w a
area	a r E a
area	E r E
argentina	a d_0Z E n t_h i n E
argentina	a r E n t_> i n a
armed	a m d
armed	a r m E d
armenian	a m i n E n
armenian	a r m E n i a n
army	a m i
army	a r m j
aroganeng	a r O x a n E N
arogantse	a r O x a n ts_> E
arogantswe	a r O x a n ts_> w E
arogantsweng	a r O x a n ts_> w E N
aroganyetswa	a r O x a J E ts_> w a
articles	a t_h i k_h E l s
arts	a r ts_>
arts	a t_h s
ase	a s E
asia	a s i a
asia	E d_0Z E
asian	a s i a n
asian	E d_0Z E n
assembly	a s E m b l j
assembly	E s E m b l i
assistance	E s E s t_h E n s
association	E s O s i E s E n
astronomical	a s t_h r E n O m i k_h E l
ataf	a t_> a f
atamelang	a t_> a m E l a N
aterese	a t_> E r E s E
atereseng	a t_> E r E s E N
athikele	a t_h i k_> E l E
atlanegisiwa	a tl_> a n E x i s i w a
atlantic	a t_h l a n t_h i k_h
atlega	a tl_> E x a
atlegang	a tl_> E x a N
atlege	a tl_> E x E
atlegile	a tl_> E x i l E
atlenegisa	a tl_> E n E x i s a
atlenegise	a tl_> E n E x i s E
atlhameng	a tl_h a m E N
atlhamologaneng	a tl_h a m O l O x a n E N
atolosetsa	a t_> O l O s E ts_> a
atolositsweng	a t_> O l O s i ts_> w E N
atomic	E t_h O m i k_h
aung	a u N
ausi	a u s i
australian	a u s t_> r a l i a n
australian	O s t_h r E l E n
authors	a u t_h O r
authors	O f E s
award	a w a r d
award	E w O d
b	b i
ba	b a
ba	b i E
baabi	b a b i
baagi	b a x i
baaging	b a x i N
baakangwa	b a k_> a N w a
baakanngwa	b a k_> a n N w a
baakantsweng	b a k_> a n ts_> w E N
baakanya	b a k_> a J a
baakanyetsa	b a k_> a J E ts_> a
baakaretsi	b a k_> a r E ts_> i
baamogedi	b a m O x E d i
baamogeding	b a m O x E d i N
baamogela	b a m O x E l a
baamogeladitshiamelo	b a m O x E l a d i ts_h i a m E l O
baamogeladitshwanelo	b a m O x E l a d i ts_h w a n E l O
baamogelatshiamelo	b a m O x E l a ts_h i a m E l O
baanelwa	b a n E l w a
baatlhodi	b a tl_h O d i
baba	b a b a
babalela	b a b a l E l a
babamo	b a b a m O
babatlisisi	b a b a tl_> i s i s i
babedi	b a b E d i
babelegi	b a b E l E x i
babelegisi	b a b E l E x i s i
babogedi	b a b O x E d i
babolai	b a b O l a i
babotlana	b a b O tl_> a n a
babuadipuo	b a b u a d i p_> u O
babueledi	b a b u E l E d i
babuisi	b a b u i s i
badan	b a d a n
badan	b a d E n
badimong	b a d i m O N
badiradikopo	b a d i r a d i k_> O p_> O
badirakopo	b a d i r a k_> O p_> O
badirammogo	b a d i r a m m O x O
badiredi	b a d i r E d i
badiredipuso	b a d i r E d i p_> u s O
badirelaboemong	b a d i r E l a b O E m O N
badirelwa	b a d i r E l w a
badiri	b a d i r i
badiring	b a d i r i N
badirisi	b a d i r i s i
baditshaba	b a d i ts_h a b a
baeletsi	b a E l E ts_> i
baemedi	b a E m E d i
baeng	b a E N
baeoloji	b a E O l O d_0Z i
baeteledipele	b a E t_> E l E d i p_> E l E
bafokeng	b a f O k_> E N
bagaetsho	b a x a E ts_h O
bagaetshong	b a x a E ts_h O N
bagobadi	b a x O b a d i
bagolo	b a x O l O
bagolong	b a x O l O N
bagwebisani	b a x w E b i s a n i
bahuduga	b a h u d u x a
baithuti	b a i t_h u t_> i
bajaboswa	b a d_0Z a b O s w a
bajanala	b a d_0Z a n a l a
bakaedi	b a k_> a E d i
bakang	b a k_> a N
bakgatla	b a kx a tl_> a
bakgweetsi	b a kx w E E ts_> i
bakhuduthamaga	b a k_h u d u t_h a m a x a
bakwadi	b a k_> w a d i
bakwadisi	b a k_> w a d i s i
bakwena	b a k_> w E n a
bala	b a l a
balaodi	b a l a O d i
bale	b a l E
bale	b E l
baleka	b a l E k_> a
balekane	b a l E k_> a n E
balelapa	b a l E l a p_> a
balele	b a l E l E
balelwa	b a l E l w a
balemi	b a l E m i
balemirui	b a l E m i r u i
balosika	b a l O s i k_> a
balwa	b a l w a
ban	b a n
bana	b a n a
banaka	b a n a k_> a
baneelakatiso	b a n E E l a k_> a t_> i s O
baneelanakatirelo	b a n E E l a n a k_> a t_> i r E l O
banetetshi	b a n E t_> E ts_h i
banetshi	b a n E ts_h i
bangwe	b a N w E
banka	b a n k_> a
banks	b a n k_>
banks	b a N k_h s
banna	b a n n a
bannaleseabeng	b a n n a l E s E a b E N
bano	b a n O
bantlhoile	b a n tl_h O i l E
bantomo	b a n t_> O m O
bantsho	b a n ts_h O
bantsi	b a n ts_> i
bantšhwa	b a n tS_h w a
banyalani	b a J a l a n i
bao	b a O
baoki	b a O k_> i
baoloji	b a O l O d_0Z i
bapa	b a p_> a
bapagami	b a p_> a x a m i
bapatsa	b a p_> a ts_> a
bapisiwa	b a p_> i s i w a
baporofešenale	b a p_> O r O f E S E n a l E
barack	b a r E k_h
bareetsi	b a r E E ts_> i
bareki	b a r E k_> i
baromela	b a r O m E l a
baromelateng	b a r O m E l a t_> E N
barui	b a r u i
baruni	b a r u n i
barutabana	b a r u t_> a b a n a
barutisi	b a r u t_> i s i
barutwana	b a r u t_> w a n a
basadi	b a s a d i
basasanki	b a s a s a n k_> i
base	b a s E
base	b E s
baseball	b a s E b a l l
baseball	b E s b O l
basimane	b a s i m a n E
basweu	b a s w E u
bathapi	b a t_h a p_> i
bathaping	b a t_h a p_> i N
bathapiwa	b a t_h a p_> i w a
bathelesi	b a t_h E l E s i
batho	b a t_h O
bathong	b a t_h O N
bathusi	b a t_h u s i
batla	b a tl_> a
batlamedi	b a tl_> a m E d i
batlang	b a tl_> a N
batlatshedimosetso	b a tl_> a ts_h E d i m O s E ts_> O
batle	b a tl_> E
batlega	b a tl_> E x a
batlegang	b a tl_> E x a N
batleng	b a tl_> E N
batlhagisi	b a tl_h a x i s i
batlhami	b a tl_h a m i
batlhankedi	b a tl_h a n k_> E d i
batlhankedikhuduthamaga	b a tl_h a n k_> E d i k_h u d u t_h a m a x a
batlhankela	b a tl_h a n k_> E l a
batlharos	b a tl_h a r O s
batlhatlhobi	b a tl_h a tl_h O b i
batlhokomedi	b a tl_h O k_> O m E d i
batlhokomelo	b a tl_h O k_> O m E l O
batlhokomelwa	b a tl_h O k_> O m E l w a
batlhophi	b a tl_h O p_h i
batlile	b a tl_> i l E
batlisisa	b a tl_> i s i s a
batokafala	b a t_> O k_> a f a l a
batsadi	b a ts_> a d i
batsamaisi	b a ts_> a m a i s i
batsamayakadinao	b a ts_> a m a j a k_> a d i n a O
batsayakarolo	b a ts_> a j a k_> a r O l O
batsereganyi	b a ts_> E r E x a J i
batshabi	b a ts_h a b i
batshwariwa	b a ts_h w a r i w a
batshwarwa	b a ts_h w a r w a
batsofe	b a ts_> O f E
batsofeng	b a ts_> O f E N
batswakwa	b a ts_> w a k_> w a
batswana	b a ts_> w a n a
batswantle	b a ts_> w a n tl_> E
batswasetlhabelo	b a ts_> w a s E tl_h a b E l O
batsweletsi	b a ts_> w E l E ts_> i
batšhotšhisi	b a tS_h O tS_h i s i
bay	b a j
bay	b E
baya	b a j a
bayokerafi	b a j O k_> E r a f i
bayothekenoloji	b a j O t_h E k_> E n O l O d_0Z i
bašwa	b a S w a
be	b E
be	b i
bebofatsa	b E b O f a ts_> a
bebofatse	b E b O f a ts_> E
bedi	b E d i
bedio	b E d i O
beela	b E E l a
beeleditsweng	b E E l E d i ts_> w E N
beeletsa	b E E l E ts_> a
beelwa	b E E l w a
beetse	b E E ts_> E
beetswe	b E E ts_> w E
beetsweng	b E E ts_> w E N
bega	b E x a
begela	b E x E l a
begile	b E x i l E
begiwa	b E x i w a
begwe	b E x w E
beile	b E i l E
beileng	b E i l E N
beili	b E i l i
beilweng	b E i l w E N
beke	b E k_> E
belaela	b E l a E l a
belegweng	b E l E x w E N
beng	b E N
benoni	b E n O n i
beryl	b E r E l
beryl	b E r j l
bese	b E s E
betsho	b E ts_h O
betshong	b E ts_h O N
bewa	b E w a
bewang	b E w a N
bewe	b E w E
bfokotse	b f O k_> O ts_> E
bgo	b O
bi	b i
biditse	b i d i ts_> E
bidiwa	b i d i w a
bidiwang	b i d i w a N
bidiwe	b i d i w E
bile	b a l
bile	b i l E
bileditswe	b i l E d i ts_> w E
bill	b E l
bill	b i l l
billy	b E l i
billy	b i l l j
bin	b E n
bin	b i n
binary	b a n E r i
binary	b i n a r j
biro	b i r O
bitsa	b i ts_> a
black	b l a k_h
blair	b l a i r
blair	b l E r
bloc	b l O k_h
blood	b l a d
blood	b l O O d
bo	b O
boa	b O
boa	b O a
boaforika	b O a f O r i k_> a
boagi	b O a x i
boaging	b O a x i N
boakaretsi	b O a k_> a r E ts_> i
boalo	b O a l O
boammaaruri	b O a m m a r u r i
boanamo	b O a n a m O
boapeelong	b O a p_> E E l O N
boatleng	b O a tl_> E N
boatlhamo	b O a tl_h a m O
boatlhodi	b O a tl_h O d i
bobalatlotlo	b O b a l a tl_> O tl_> O
bobapatsi	b O b a p_> a ts_> i
bobebe	b O b E b E
bobedi	b O b E d i
bobeding	b O b E d i N
bobegakgang	b O b E x a kx a N
bobididi	b O b i d i d i
boboa	b O b O a
bobod	b O b O d
bobodu	b O b O d u
bobolokelo	b O b O l O k_> E l O
bobolokelong	b O b O l O k_> E l O N
bobosisi	b O b O s i s i
bobotlana	b O b O tl_> a n a
bobusisi	b O b u s i s i
bodibe	b O d i b E
bodidi	b O d i d i
bodiredi	b O d i r E d i
bodirelo	b O d i r E l O
bodiri	b O d i r i
bodit	b O d i t_>
bodithaba	b O d i t_h a b a
boditshabatshaba	b O d i ts_h a b a ts_h a b a
boditswe	b O d i ts_> w E
boditšhaba	b O d i tS_h a b a
boditšhabatšhaba	b O d i tS_h a b a tS_h a b a
bodiwa	b O d i w a
bodumaduma	b O d u m a d u m a
bodumatau	b O d u m a t_> a u
bodumedi	b O d u m E d i
bodutelo	b O d u t_> E l O
bodutiso	b O d u t_> i s O
boe	b O E
boela	b O E l a
boele	b O E l E
boeletsa	b O E l E ts_> a
boelweng	b O E l w E N
boemadifofane	b O E m a d i f O f a n E
boemaditimela	b O E m a d i t_> i m E l a
boemakepe	b O E m a k_> E p_> E
boemedi	b O E m E d i
boemelong	b O E m E l O N
boemeng	b O E m E N
boemo	b O E m O
boemong	b O E m O N
boenjeniri	b O E n d_0Z E n i r i
boenjiniri	b O E n d_0Z i n i r i
boeteledipele	b O E t_> E l E d i p_> E l E
bofe	b O f E
bofegile	b O f E x i l E
bofelo	b O f E l O
bofelong	b O f E l O N
bofitlha	b O f i tl_h a
bogadi	b O x a d i
bogaisani	b O x a i s a n i
bogale	b O x a l E
bogaleng	b O x a l E N
bogareng	b O x a r E N
bogautshwane	b O x a u ts_h w a n E
bogela	b O x E l a
bogobe	b O x O b E
bogodimo	b O x O d i m O
bogodimong	b O x O d i m O N
bogodu	b O x O d u
bogokaganyi	b O x O k_> a x a J i
bogole	b O x O l E
bogolo	b O x O l O
bogologolo	b O x O l O x O l O
bogologolotala	b O x O l O x O l O t_> a l a
bogolong	b O x O l O N
bogolosegolo	b O x O l O s E x O l O
bogorogelo	b O x O r O x E l O
bogotlhe	b O x O tl_h E
boikaelelo	b O i k_> a E l E l O
boikakanyetsi	b O i k_> a k_> a J E ts_> i
boikanyego	b O i k_> a J E x O
boikanyo	b O i k_> a J O
boikarabelo	b O i k_> a r a b E l O
boikgethelo	b O i kx E t_h E l O
boikhutso	b O i k_h u ts_> O
boikuelo	b O i k_> u E l O
boikuelong	b O i k_> u E l O N
boikwadiso	b O i k_> w a d i s O
boile	b O i l E
boima	b O i m a
boimana	b O i m a n a
boimanyana	b O i m a J a n a
boineelo	b O i n E E l O
boingotlo	b O i N O tl_> O
boipelo	b O i p_> E l O
boiphemelo	b O i p_h E m E l O
boiphitlhelelo	b O i p_h i tl_h E l E l O
boipiletso	b O i p_> i l E ts_> O
boipobolo	b O i p_> O b O l O
boitapoloso	b O i t_> a p_> O l O s O
boitekanelo	b O i t_> E k_> a n E l O
boitekanelong	b O i t_> E k_> a n E l O N
boiteko	b O i t_> E k_> O
boithaopi	b O i t_h a O p_> i
boithusetso	b O i t_h u s E ts_> O
boithutedi	b O i t_h u t_> E d i
boithutelatirong	b O i t_h u t_> E l a t_> i r O N
boithuti	b O i t_h u t_> i
boitlamo	b O i tl_> a m O
boitlhamedi	b O i tl_h a m E d i
boitlhamelo	b O i tl_h a m E l O
boitlhophelo	b O i tl_h O p_h E l O
boitseanape	b O i ts_> E a n a p_> E
boitshenkedi	b O i ts_h E n k_> E d i
boitshepo	b O i ts_h E p_> O
boitsholo	b O i ts_h O l O
boitshupo	b O i ts_h u p_> O
boitshwaro	b O i ts_h w a r O
boitumelo	b O i t_> u m E l O
boitumelong	b O i t_> u m E l O N
bojala	b O d_0Z a l a
bojalwa	b O d_0Z a l w a
bojanala	b O d_0Z a n a l a
bojang	b O d_0Z a N
bojona	b O d_0Z O n a
bojotlhe	b O d_0Z O tl_h E
bokaedi	b O k_> a E d i
bokaeding	b O k_> a E d i N
bokaelo	b O k_> a E l O
bokalo	b O k_> a l O
bokamoso	b O k_> a m O s O
bokana	b O k_> a n a
bokao	b O k_> a O
bokaobontsi	b O k_> a O b O n ts_> i
bokaong	b O k_> a O N
bokaopedi	b O k_> a O p_> E d i
bokatisi	b O k_> a t_> i s i
bokete	b O k_> E t_> E
bokgabane	b O kx a b a n E
bokgaga	b O kx a x a
bokgo	b O kx O
bokgonegang	b O kx O n E x a N
bokgoni	b O kx O n i
bokgoning	b O kx O n i N
bokgweetsi	b O kx w E E ts_> i
bokhutlhong	b O k_h u tl_h O N
bokhutlo	b O k_h u tl_> O
bokhutlong	b O k_h u tl_> O N
bokoa	b O k_> O a
bokolela	b O k_> O l E l a
bokone	b O k_> O n E
bokopatshireletso	b O k_> O p_> a ts_h i r E l E ts_> O
bokwadi	b O k_> w a d i
bokwadisetso	b O k_> w a d i s E ts_> O
bokwadisi	b O k_> w a d i s i
bolaile	b O l a i l E
bolaileng	b O l a i l E N
bolaisa	b O l a i s a
bolao	b O l a O
bolaodi	b O l a O d i
bolaodijwamatlole	b O l a O d i d_0Z w a m a tl_> O l E
bolaoding	b O l a O d i N
bolayang	b O l a j a N
boleele	b O l E E l E
bolela	b O l E l a
bolelela	b O l E l E l a
bolelelang	b O l E l E l a N
bolelele	b O l E l E l E
bolelo	b O l E l O
boleng	b O l E N
boletsweng	b O l E ts_> w E N
boloi	b O l O i
boloka	b O l O k_> a
bolokaneng	b O l O k_> a n E N
bolokegileng	b O l O k_> E x i l E N
bolokelang	b O l O k_> E l a N
bolokiwa	b O l O k_> i w a
bolokong	b O l O k_> O N
bolokwa	b O l O k_> w a
bolokwe	b O l O k_> w E
bolong	b O l O N
bolosika	b O l O s i k_> a
bolotsa	b O l O ts_> a
bolthole	b O l t_h O l E
bolumo	b O l u m O
bolumong	b O l u m O N
bolumu	b O l u m u
bolwetse	b O l w E ts_> E
bolwetsi	b O l w E ts_> i
boma	b O m a
bomagiseterata	b O m a x i s E t_> E r a t_> a
bomaitseanape	b O m a i ts_> E a n a p_> E
bomang	b O m a N
bomankge	b O m a n kx E
bomaratahelele	b O m a r a t_> a h E l E l E
bomba	b O m b a
bombas	b O m b a s
bombastiki	b O m b a s t_> i k_> i
bomefutafuta	b O m E f u t_> a f u t_> a
bomma	b O m m a
bommaabana	b O m m a b a n a
bommalamatlotlo	b O m m a l a m a tl_> O tl_> O
bommasepala	b O m m a s E p_> a l a
bomme	b O m m E
bommemme	b O m m E m m E
bomo	b O m O
bona	b O n a
bonagalang	b O n a x a l a N
bonako	b O n a k_> O
bonale	b O n a l E
bonang	b O n a N
bonatshedimosetso	b O n a ts_h E d i m O s E ts_> O
bone	b O n
bone	b O n E
boneng	b O n E N
bonetetshi	b O n E t_> E ts_h i
bonetshi	b O n E ts_h i
bong	b O N
bongane	b O N a n E
bongiwe	b O N i w E
bongola	b O N O l a
bongwe	b O N w E
bongwetsi	b O N w E ts_> i
bonnete	b O n n E t_> E
bonno	b O n n O
bonnyane	b O n J a n E
bonnye	b O n J E
bonolo	b O n O l O
bonosi	b O n O s i
bonosing	b O n O s i N
bonota	b O n O t_> a
bont	b O E n t_> i
bontate	b O n t_> a t_> E
bontle	b O n tl_> E
bontlha	b O n tl_h a
bontlhabongwe	b O n tl_h a b O N w E
bontlhopheng	b O n tl_h O p_h E N
bontsha	b O n ts_h a
bontshang	b O n ts_h a N
bontshe	b O n ts_h E
bontshitswe	b O n ts_h i ts_> w E
bontshitsweng	b O n ts_h i ts_> w E N
bontshiwa	b O n ts_h i w a
bontshiwang	b O n ts_h i w a N
bontsho	b O n ts_h O
bontsi	b O n ts_> i
bonwa	b O n w a
bonwang	b O n w a N
bonwe	b O n w E
bonweng	b O n w E N
boo	b O O
boo	b u
book	b O O k_>
book	b u k_h
bookelo	b O O k_> E l O
bookelong	b O O k_> E l O N
bopa	b O p_> a
bopaki	b O p_> a k_> i
bopalamelo	b O p_> a l a m E l O
bopang	b O p_> a N
bope	b O p_> E
bopelokgale	b O p_> E l O kx a l E
bopeng	b O p_> E N
bophara	b O p_h a r a
bophasalatsi	b O p_h a s a l a ts_> i
bophelo	b O p_h E l O
bophepa	b O p_h E p_> a
bophiri	b O p_h i r i
bophirima	b O p_h i r i m a
bopiwa	b O p_> i w a
borakanelo	b O r a k_> a n E l O
borakonteraka	b O r a k_> O n t_> E r a k_> a
boramolao	b O r a m O l a O
boraoseng	b O r a O s E N
boraro	b O r a r O
border	b O d E r
border	b O r d E r
borekhu	b O r E k_h u
borekisetsong	b O r E k_> i s E ts_> O N
borethe	b O r E t_h E
borobalo	b O r O b a l O
borogo	b O r O x O
boromiwa	b O r O m i w a
boromiwang	b O r O m i w a N
boromiweng	b O r O m i w E N
borongwa	b O r O N w a
borongweng	b O r O N w E N
borra	b O r r a
borumolano	b O r u m O l a n O
boruni	b O r u n i
borutabana	b O r u t_> a b a n a
borutegi	b O r u t_> E x i
boruteging	b O r u t_> E x i N
borwa	b O r w a
bosa	b O s a
bosalala	b O s a l a l a
bosebele	b O s E b E l E
bosekaseki	b O s E k_> a s E k_> i
bosele	b O s E l E
bosemmuso	b O s E m m u s O
bosemorafe	b O s E m O r a f E
bosenyi	b O s E J i
bosenyimolato	b O s E J i m O l a t_> O
bosephiri	b O s E p_h i r i
boseriti	b O s E r i t_> i
boset	b O s E t_>
bosethaba	b O s E t_h a b a
bosetshaba	b O s E ts_h a b a
bosetšhaba	b O s E tS_h a b a
bosiamisi	b O s i a m i s i
bosigo	b O s i x O
bosika	b O s i k_> a
boston	b O s t_h E n
boston	b O s t_> O n
bosula	b O s u l a
bosupi	b O s u p_> i
boswa	b O s w a
bosweu	b O s w E u
bot	b O t_>
botaki	b O t_> a k_> i
botala	b O t_> a l a
boteng	b O t_> E N
bothani	b O t_h a n i
bothata	b O t_h a t_> a
bothati	b O t_h a t_> i
bothating	b O t_h a t_> i N
bothaville	b O t_h a f E l
bothaville	b O t_h a i l l E
bothito	b O t_h i t_> O
botho	b O t_h O
bothusi	b O t_h u s i
botlalo	b O tl_> a l O
botlh	b O t_> i a l E tS_h
botlhaba	b O tl_h a b a
botlhabelong	b O tl_h a b E l O N
botlhabongwe	b O tl_h a b O N w E
botlhagisi	b O tl_h a x i s i
botlhagisipele	b O tl_h a x i s i p_> E l E
botlhale	b O tl_h a l E
botlhalefi	b O tl_h a l E f i
botlhami	b O tl_h a m i
botlhaswa	b O tl_h a s w a
botlhatlhobi	b O tl_h a tl_h O b i
botlhatsi	b O tl_h a ts_> i
botlhe	b O tl_h E
botlhokatiro	b O tl_h O k_> a t_> i r O
botlhoko	b O tl_h O k_> O
botlhokwa	b O tl_h O k_> w a
botlhole	b O tl_h O l E
botlhotlhwa	b O tl_h O tl_h w a
boto	b O t_> O
botoka	b O t_> O k_> a
botokololo	b O t_> O k_> O l O l O
botona	b O t_> O n a
botsa	b O ts_> a
botsadi	b O ts_> a d i
botsadikatsho	b O ts_> a d i k_> a ts_h O
botsadikatsholo	b O ts_> a d i k_> a ts_h O l O
botsalano	b O ts_> a l a n O
botsalo	b O ts_> a l O
botsamaisi	b O ts_> a m a i s i
botsamaising	b O ts_> a m a i s i N
botsamaisng	b O ts_> a m a i s N
botsamisi	b O ts_> a m i s i
botsang	b O ts_> a N
botsayakarolo	b O ts_> a j a k_> a r O l O
botse	b O ts_> E
botseneledi	b O ts_> E n E l E d i
botsenong	b O ts_> E n O N
botsereganyi	b O ts_> E r E x a J i
botseta	b O ts_> E t_> a
botseteng	b O ts_> E t_> E N
botshabelo	b O ts_h a b E l O
botshabi	b O ts_h a b i
botshelo	b O ts_h E l O
botshelong	b O ts_h E l O N
botsholamatlotlong	b O ts_h O l a m a tl_> O tl_> O N
botshwarehile	b O ts_h w a r E h i l E
botso	b O ts_> O
botsogo	b O ts_> O x O
botsolotsa	b O ts_> O l O ts_> a
botswana	b O t_h s w E n E
botswana	b O ts_> w a n a
botswerere	b O ts_> w E r E r E
botsweretshi	b O ts_> w E r E ts_h i
botšarara	b O tS_> a r a r a
boutela	b O u t_> E l a
bowa	b O w a
box	b O
box	b O k_h s
bošwa	b O S w a
bra	b r a
brakpan	b r a k_h p_h a n
brakpan	b r a k_> p_> a n
brand	b r a n d
breyten	b r E j t_> E n
breyten	b r E t_h E n
bridget	b r i d_0Z E t_h
bridget	b r i d E t_>
brithani	b r i t_h a n i
british	b r E t_h i s
british	b r i t_> i s
brixton	b r i k_h s t_h E n
brixton	b r i t_> O n
brock	b r O k_h
bronze	b r O n s
bua	b u a
buang	b u a N
buccaneers	b a k_h E n E s
bue	b u E
buile	b u i l E
buisa	b u i s a
buisalebelela	b u i s a l E b E l E l a
buisana	b u i s a n a
buisane	b u i s a n E
buisang	b u i s a N
buisega	b u i s E x a
buisegang	b u i s E x a N
buisegeng	b u i s E x E N
buisetsa	b u i s E ts_> a
buisitse	b u i s i ts_> E
buisiwang	b u i s i w a N
buiwang	b u i w a N
buka	b u k_> a
bukana	b u k_> a n a
bukeng	b u k_> E N
bula	b u l a
bulawayo	b u l a w a j O
bulegile	b u l E x i l E
bulela	b u l E l a
bulelwa	b u l E l w a
bulwa	b u l w a
bulwang	b u l w a N
bulwe	b u l w E
busa	b u s a
busang	b u s a N
busediwa	b u s E d i w a
busediwang	b u s E d i w a N
busediweng	b u s E d i w E N
busetsa	b u s E ts_> a
busetse	b u s E ts_> E
busetswa	b u s E ts_> w a
butswe	b u ts_> w E
butsweng	b u ts_> w E N
by	b a
by	b j
c	s i
ca	k_h a
cacadu	k_h a k_h a d u
camagu	k_h a m E k_> u
campus	k_h a m p_h E s
canadian	k_h E n E d E n
cape	k_h E p_h
cardiovascular	k_h a d i O f a s k_h j u l E r
catholic	k_h a f l i k_h
catholics	k_h a f l i k_h s
cathrina	k_h E t_h r i n E
cc	k_h
cc	s i s i
ccfarologanya	k_h f E r O l E k_> E n i E
ccma	k_h m E
ccma	s i s i E m E
cd	k_h d
cd	s i d i
ce	s
center	s E n t_h E r
central	s E n t_h r E l
centrally	s E n t_h r E l i
century	s E n tS_h E r i
certified	s a t_h E f a d
cgo	k_h k_> O
cgore	k_h k_> O r
chain	tS_h E n
chargers	tS_h a d_0Z E s
chat	tS_h a t_h
chili	tS_h E l i
chinese	tS_h a n i s
ching	t_h s i N
church	tS_h a tS_h
churches	tS_h a tS_h E s
cite	s a t_h
city	s E t_h i
civil	s E f E l
clarify	k_h l a r E f a
class	k_h l a s
classical	k_h l a s i k_h E l
clerk	k_h l a k_h
clinic	k_h l E n i k_h
clocolan	k_h l O k_h E l E n
close	k_h l O s
club	k_h l a b
clubs	k_h l a b s
coast	k_h O s t_h
codex	k_h O d E k_h s
cold	k_h O l d
college	k_h O l i d_0Z
colleges	k_h O l i d_0Z E s
colonel	k_h O l O n E l
comedy	k_h O m E d i
comic	k_h O m i k_h
command	k_h E m a n d
commission	k_h E m i s E n
common	k_h O m E n
community	k_h E m j u n E t_h i
company	k_h a m p_h E n i
comparisons	k_h E m p_h a r E s E n s
complaining	k_h E m p_h l E n i N
compression	k_h E m p_h r E s E n
concepts	k_h O n s E p_h t_h s
confederacy	k_h E n f E d E r E s i
conference	k_h O n f E r E n s
congo	k_h O N k_> O
constitution	k_h O n s t_h i t_h j u s E n
continental	k_h O n t_h i n E n t_h E l
control	k_h E n t_h r O l
convention	k_h E n f E n s E n
cooper	k_h O O p_h E r
coppola	k_h O p_h E l E
coptic	k_h O p_h t_h i k_h
copy	k_h O p_h i
corporation	k_h O p_h E r E s E n
correctional	k_h E r E k_h s E n E l
council	k_h a n s E l
countries	k_h a n t_h r i s
court	k_h O t_h
courts	k_h O t_h s
crown	k_h r a n
crystal	k_h r E s t_h E l
csdp	k_h s d p_h
csdp	s i E s d i p_h i
cup	k_h a p_h
curriculum	k_h E r i k_h j u l E m
customs	k_h a s t_h E m s
d	d i
da	d a
da	d i E
danida	d a n i d a
daniel	d a n E l
daniel	d a n i E l
data	d a t_> a
data	d E t_h E
date	d a t_> E
date	d E t_h
dau	d a u
de	d E
dea	d E a
dead	d E a d
dead	d E d
deat	d E a t_>
deaths	d E a t_h
deaths	d E f s
december	d i s E m b E r
declared	d i k_h l E d
defence	d i f E n s
defense	d E f E n s
defense	d E f E n s E
democratic	d E m E k_h r a t_h i k_h
density	d E n s E t_h i
density	d E n s i t_> j
deon	d E O n
department	d E p_> a r t_> m E n t_>
department	d i p_h a t_h m E n t_h
deri	d E r i
development	d E E l O p_> m E n t_>
development	d i f E l E p_h m E n t_h
di	d a
di	d i
dia	d i a
diafokate	d i a f O k_> a t_> E
diakhaefe	d i a k_h a E f E
dianelalebopo	d i a n E l a l E b O p_> O
diaparo	d i a p_> a r O
diapei	d i a p_> E i
diartikele	d i a r t_> i k_> E l E
diaterese	d i a t_> E r E s E
diathikele	d i a t_h i k_> E l E
diatla	d i a tl_> a
diatleng	d i a tl_> E N
dibaga	d i b a x a
dibankeng	d i b a n k_> E N
dibasari	d i b a s a r i
dibebofatsi	d i b E b O f a ts_> i
dibedio	d i b E d i O
dibeke	d i b E k_> E
dibekeng	d i b E k_> E N
dibene	d i b E n E
dibenya	d i b E J a
dibese	d i b E s E
dibeso	d i b E s O
dibetšhe	d i b E tS_h E
dibogelwa	d i b O x E l w a
diboko	d i b O k_> O
dibokosong	d i b O k_> O s O N
dibolai	d i b O l a i
dibolaya	d i b O l a j a
diboroutšhara	d i b O r O u tS_h a r a
dibotlolo	d i b O tl_> O l O
dibuka	d i b u k_> a
didimala	d i d i m a l a
didimalang	d i d i m a l a N
didirisiwa	d i d i r i s i w a
didiriswa	d i d i r i s w a
diedi	d i E d i
diego	d i E k_> O
diego	d i E x O
dielo	d i E l O
diensaetlelopedia	d i E n s a E tl_> E l O p_> E d i a
difaele	d i f a E l E
difaeleng	d i f a E l E N
difane	d i f a n E
dife	d i f E
difeme	d i f E m E
difensetere	d i f E n s E t_> E r E
difilimi	d i f i l i m i
difofane	d i f O f a n E
diforamo	d i f O r a m O
diforomo	d i f O r O m O
diga	d i x a
digatlhamelamasisi	d i x a tl_h a m E l a m a s i s i
digile	d i x i l E
digole	d i x O l E
digoro	d i x O r O
diintaseteri	d i i n t_> a s E t_> E r i
dijalo	d i d_0Z a l O
dijanaga	d i d_0Z a n a x a
dijenale	d i d_0Z E n a l E
dijo	d i d_0Z O
dika	d i k_> a
dikaelo	d i k_> a E l O
dikago	d i k_> a x O
dikahisetori	d i k_> a h i s E t_> O r i
dikai	d i k_> a i
dikakanyo	d i k_> a k_> a J O
dikakanyong	d i k_> a k_> a J O N
dikale	d i k_> a l E
dikamano	d i k_> a m a n O
dikanedi	d i k_> a n E d i
dikanego	d i k_> a n E x O
dikantoro	d i k_> a n t_> O r O
dikantorong	d i k_> a n t_> O r O N
dikao	d i k_> a O
dikapuo	d i k_> a p_> u O
dikarabo	d i k_> a r a b O
dikaroganyo	d i k_> a r O x a J O
dikarolo	d i k_> a r O l O
dikarolong	d i k_> a r O l O N
dikarolotlaleletso	d i k_> a r O l O tl_> a l E l E ts_> O
dikatlanegiso	d i k_> a tl_> a n E x i s O
dikatso	d i k_> a ts_> O
dikeledi	d i k_> E l E d i
dikeletso	d i k_> E l E ts_> O
dikema	d i k_> E m a
dikemedi	d i k_> E m E d i
dikemeding	d i k_> E m E d i N
dikepe	d i k_> E p_> E
dikerafo	d i k_> E r a f O
dikereiti	d i k_> E r E i t_> i
diketleetso	d i k_> E tl_> E E ts_> O
dikgakologo	d i kx a k_> O l O x O
dikgakololo	d i kx a k_> O l O l O
dikgamolo	d i kx a m O l O
dikgamu	d i kx a m u
dikgang	d i kx a N
dikgano	d i kx a n O
dikgaolo	d i kx a O l O
dikgapo	d i kx a p_> O
dikgatako	d i kx a t_> a k_> O
dikgatholoso	d i kx a t_h O l O s O
dikgatiso	d i kx a t_> i s O
dikgatlhegelo	d i kx a tl_h E x E l O
dikgatlhegelong	d i kx a tl_h E x E l O N
dikgato	d i kx a t_> O
dikgatong	d i kx a t_> O N
dikgetsana	d i kx E ts_> a n a
dikgetse	d i kx E ts_> E
dikgetsi	d i kx E ts_> i
dikgobalo	d i kx O b a l O
dikgogakano	d i kx O x a k_> a n O
dikgoka	d i kx O k_> a
dikgokagano	d i kx O k_> a x a n O
dikgolagano	d i kx O l a x a n O
dikgolo	d i kx O l O
dikgomo	d i kx O m O
dikgopo	d i kx O p_> O
dikgopolo	d i kx O p_> O l O
dikgoreletsi	d i kx O r E l E ts_> i
dikgorokagano	d i kx O r O k_> a x a n O
dikgotlang	d i kx O tl_> a N
dikgotlatshekelo	d i kx O tl_> a ts_h E k_> E l O
dikgotlatshekelong	d i kx O tl_> a ts_h E k_> E l O N
dikgotlhang	d i kx O tl_h a N
dikgwa	d i kx w a
dikgwebisano	d i kx w E b i s a n O
dikgwebo	d i kx w E b O
dikgwedi	d i kx w E d i
dikgweding	d i kx w E d i N
dikgwetlho	d i kx w E tl_h O
dikhabara	d i k_h a b a r a
dikhabareng	d i k_h a b a r E N
dikhalentara	d i k_h a l E n t_> a r a
dikhamphane	d i k_h a m p_h a n E
dikhansele	d i k_h a n s E l E
dikhatoneng	d i k_h a t_> O n E N
dikhemikale	d i k_h E m i k_> a l E
dikhibidu	d i k_h i b i d u
dikhopi	d i k_h O p_> i
dikhoping	d i k_h O p_> i N
dikhouto	d i k_h O u t_> O
dikhoutu	d i k_h O u t_> u
dikile	d i k_> i l E
dikinane	d i k_> i n a n E
dikirii	d i k_> i r i i
dikitsiso	d i k_> i ts_> i s O
dikoketso	d i k_> O k_> E ts_> O
dikoko	d i k_> O k_> O
dikokwana	d i k_> O k_> w a n a
dikolo	d i k_> O l O
dikologa	d i k_> O l O x a
dikolong	d i k_> O l O N
dikomiti	d i k_> O m i t_> i
dikopano	d i k_> O p_> a n O
dikopelo	d i k_> O p_> E l O
dikopo	d i k_> O p_> O
dikotla	d i k_> O tl_> a
dikotlo	d i k_> O tl_> O
dikotsi	d i k_> O ts_> i
dikumo	d i k_> u m O
dikumong	d i k_> u m O N
dikuno	d i k_> u n O
dikuranta	d i k_> u r a n t_> a
dikwalo	d i k_> w a l O
dikwalwa	d i k_> w a l w a
dikwatlhao	d i k_> w a tl_h a O
dilaesense	d i l a E s E n s E
dileele	d i l E E l E
dilekanyo	d i l E k_> a J O
dilo	d i l O
dilori	d i l O r i
dilwana	d i l w a n a
dimakasine	d i m a k_> a s i n E
dimametlelelo	d i m a m E tl_> E l E l O
dimec	d i m E k_h
dimela	d i m E l a
dimenerale	d i m E n E r a l E
dimetara	d i m E t_> a r a
dimilione	d i m i l i O n E
diminerala	d i m i n E r a l a
diminerale	d i m i n E r a l E
dimpho	d i m p_h O
din	d E n
din	d i n
dinaga	d i n a x a
dinagapula	d i n a x a p_> u l a
dinageng	d i n a x E N
dinaka	d i n a k_> a
dinako	d i n a k_> O
dinao	d i n a O
dinare	d i n a r E
dineo	d i n E O
dinepe	d i n E p_> E
dingaka	d i N a k_> a
dingangisano	d i N a N i s a n O
dingongorego	d i N O N O r E x O
dingwaga	d i N w a x a
dingwageng	d i N w a x E N
dingwe	d i N w E
dingwgeng	d i N w E N
dinku	d i n k_> u
dinngwe	d i n N w E
dinnye	d i n J E
dinoka	d i n O k_> a
dinokana	d i n O k_> a n a
dinokaneng	d i n O k_> a n E N
dinoko	d i n O k_> O
dinokwane	d i n O k_> w a n E
dinomoro	d i n O m O r O
dinomoroitshupo	d i n O m O r O i ts_h u p_> O
dinong	d i n O N
dinonyane	d i n O J a n E
dinotagi	d i n O t_> a x i
dinotlolo	d i n O tl_> O l O
dint	d E n t_h
dint	d i n t_>
dintha	d i n t_h a
dintlha	d i n tl_h a
dintlhana	d i n tl_h a n a
dintlhatheo	d i n tl_h a t_h E O
dintlheng	d i n tl_h E N
dintlo	d i n tl_> O
dintse	d i n ts_> E
dintshamenong	d i n ts_h a m E n O N
dintsho	d i n ts_h O
dintshwa	d i n ts_h w a
dintsi	d i n ts_> i
dintsinyana	d i n ts_> i J a n a
dintšhwa	d i n tS_h w a
dinyaga	d i J a x a
dinyageng	d i J a x E N
dinyana	d i J a n a
dinyemisa	d i J E m i s a
diofising	d i O f i s i N
dipaakanyo	d i p_> a k_> a J O
dipaka	d i p_> a k_> a
dipaki	d i p_> a k_> i
dipalamo	d i p_> a l a m O
dipalangwa	d i p_> a l a N w a
dipalo	d i p_> a l O
dipalogotlhe	d i p_> a l O x O tl_h E
dipampiri	d i p_> a m p_> i r i
dipampitshana	d i p_> a m p_> i ts_h a n a
dipapetlanapepentsho	d i p_> a p_> E tl_> a n a p_> E p_> E n ts_h O
dipatlisiso	d i p_> a tl_> i s i s O
dipatlisisong	d i p_> a tl_> i s i s O N
dipatsana	d i p_> a ts_> a n a
dipe	d i p_> E
dipeeletso	d i p_> E E l E ts_> O
dipegelo	d i p_> E x E l O
dipelaelo	d i p_> E l a E l O
dipente	d i p_> E n t_> E
dipeo	d i p_> E O
diphalane	d i p_h a l a n E
diphapaano	d i p_h a p_> a n O
diphaposo	d i p_h a p_> O s O
dipharologano	d i p_h a r O l O x a n O
diphasalatso	d i p_h a s a l a ts_> O
diphate	d i p_h a t_> E
diphatlatiro	d i p_h a tl_> a t_> i r O
diphemiti	d i p_h E m i t_> i
diphenene	d i p_h E n E n E
diphetišene	d i p_h E t_> i S E n E
diphetogo	d i p_h E t_> O x O
diphetolo	d i p_h E t_> O l O
diphimola	d i p_h i m O l a
diphitlhelelo	d i p_h i tl_h E l E l O
diphokoletso	d i p_h O k_> O l E ts_> O
dipholisi	d i p_h O l i s i
dipholo	d i p_h O l O
diphologolo	d i p_h O l O x O l O
diphopoletso	d i p_h O p_> O l E ts_> O
diphoso	d i p_h O s O
diphousetara	d i p_h O u s E t_> a r a
diphufudi	d i p_h u f u d i
diphuthelo	d i p_h u t_h E l O
diphuthelong	d i p_h u t_h E l O N
dipilara	d i p_> i l a r a
dipilareng	d i p_> i l a r E N
dipina	d i p_> i n a
diplomatic	d E p_h l E m a t_h i k_h
dipodi	d i p_> O d i
dipoeletso	d i p_> O E l E ts_> O
dipoelo	d i p_> O E l O
dipoelong	d i p_> O E l O N
dipolao	d i p_> O l a O
dipolase	d i p_> O l a s E
dipolelo	d i p_> O l E l O
dipoloma	d i p_> O l O m a
diponagalo	d i p_> O n a x a l O
dipone	d i p_> O n E
dipontsho	d i p_> O n ts_h O
dipopego	d i p_> O p_> E x O
dipopi	d i p_> O p_> i
diporofense	d i p_> O r O f E n s E
diporofenseng	d i p_> O r O f E n s E N
diporojeke	d i p_> O r O d_0Z E k_> E
diposokantoro	d i p_> O s O k_> a n t_> O r O
dipostal	d i p_> O s t_> a l
dipotsiso	d i p_> O ts_> i s O
dipotso	d i p_> O ts_> O
dipotsolotso	d i p_> O ts_> O l O ts_> O
dipounama	d i p_> O u n a m a
dipuisano	d i p_> u i s a n O
dipuo	d i p_> u O
dipuong	d i p_> u O N
dipusetso	d i p_> u s E ts_> O
dipusetsoditlhapiso	d i p_> u s E ts_> O d i tl_h a p_> i s O
dipusetsomorago	d i p_> u s E ts_> O m O r a x O
dipuso	d i p_> u s O
dira	d i r a
diradio	d i r a d i O
diragaditseng	d i r a x a d i ts_> E N
diragaditswe	d i r a x a d i ts_> w E
diragadiwa	d i r a x a d i w a
diragadiwang	d i r a x a d i w a N
diragala	d i r a x a l a
diragalang	d i r a x a l a N
diragaletse	d i r a x a l E ts_> E
diragatsa	d i r a x a ts_> a
diragatse	d i r a x a ts_> E
diragetseng	d i r a x E ts_> E N
dirang	d i r a N
diraporoto	d i r a p_> O r O t_> O
dire	d a E r
dire	d i r E
diregang	d i r E x a N
direge	d i r E x E
direiti	d i r E i t_> i
direkoto	d i r E k_> O t_> O
direkotong	d i r E k_> O t_> O N
direla	d i r E l a
direlwa	d i r E l w a
direlwang	d i r E l w a N
direng	d i r E N
dirente	d i r E n t_> E
diretswe	d i r E ts_> w E
diretsweng	d i r E ts_> w E N
dirile	d i r i l E
dirileng	d i r i l E N
dirilwe	d i r i l w E
dirilweng	d i r i l w E N
dirisa	d i r i s a
dirisana	d i r i s a n a
dirisane	d i r i s a n E
dirisang	d i r i s a N
dirisediwa	d i r i s E d i w a
diriseng	d i r i s E N
dirisetswa	d i r i s E ts_> w a
dirisetswang	d i r i s E ts_> w a N
dirisitswe	d i r i s i ts_> w E
dirisitsweng	d i r i s i ts_> w E N
dirisiwa	d i r i s i w a
dirisiwang	d i r i s i w a N
dirisiwe	d i r i s i w E
diriswa	d i r i s w a
diritibatsi	d i r i t_> i b a ts_> i
diriwa	d i r i w a
diriwang	d i r i w a N
dirk	d a k_h
dirk	d i r k_>
diromelwateng	d i r O m E l w a t_> E N
dirori	d i r O r i
diruburiking	d i r u b u r i k_> i N
diruiwa	d i r u i w a
dirutwa	d i r u t_> w a
dirwa	d i r w a
dirwang	d i r w a N
dirwe	d i r w E
dirweng	d i r w E N
disakatuku	d i s a k_> a t_> u k_> u
disata	d i s a t_> a
disease	d i s E a s E
disease	d i s i s
diseele	d i s E E l E
disekerete	d i s E k_> E r E t_> E
diselaete	d i s E l a E t_> E
disele	d i s E l E
diseriale	d i s E r i a l E
diserising	d i s E r i s i N
ditaba	d i t_> a b a
ditaelo	d i t_> a E l O
ditagi	d i t_> a x i
ditaletso	d i t_> a l E ts_> O
ditaolelo	d i t_> a O l E l O
ditapole	d i t_> a p_> O l E
ditasetamente	d i t_> a s E t_> a m E n t_> E
ditatamente	d i t_> a t_> a m E n t_> E
ditau	d i t_> a u
diteishene	d i t_> E i s E n E
diteišene	d i t_> E i S E n E
ditekanyetso	d i t_> E k_> a J E ts_> O
ditekisi	d i t_> E k_> i s i
diteko	d i t_> E k_> O
ditelele	d i t_> E l E l E
ditema	d i t_> E m a
ditemana	d i t_> E m a n a
ditene	d i t_> E n E
diteng	d i t_> E N
ditengwana	d i t_> E N w a n a
diterama	d i t_> E r a m a
diteraseteng	d i t_> E r a s E t_> E N
diterena	d i t_> E r E n a
ditesetamente	d i t_> E s E t_> a m E n t_> E
ditetla	d i t_> E tl_> a
ditetlokhophi	d i t_> E tl_> O k_h O p_h i
dithaba	d i t_h a b a
dithanodi	d i t_h a n O d i
dithanolo	d i t_h a n O l O
dithata	d i t_h a t_> a
dithebolelo	d i t_h E b O l E l O
dithebolo	d i t_h E b O l O
dithedimogane	d i t_h E d i m O x a n E
ditheetso	d i t_h E E ts_> O
dithekeniki	d i t_h E k_> E n i k_> i
dithekesi	d i t_h E k_> E s i
dithekisi	d i t_h E k_> i s i
dithekisontle	d i t_h E k_> i s O n tl_> E
dithekontle	d i t_h E k_> O n tl_> E
ditheo	d i t_h E O
ditheong	d i t_h E O N
ditherisano	d i t_h E r i s a n O
dithibedi	d i t_h i b E d i
ditholwana	d i t_h O l w a n a
dithota	d i t_h O t_> a
dithoto	d i t_h O t_> O
dithuanyi	d i t_h u a J i
dithulaganyetso	d i t_h u l a x a J E ts_> O
dithulaganyo	d i t_h u l a x a J O
dithuno	d i t_h u n O
dithunya	d i t_h u J a
dithuso	d i t_h u s O
dithuthupi	d i t_h u t_h u p_> i
dithutiso	d i t_h u t_> i s O
dithuto	d i t_h u t_> O
ditifikeiti	d i t_> i f i k_> E i t_> i
ditikwatikwe	d i t_> i k_> w a t_> i k_> w E
ditilo	d i t_> i l O
ditiragalo	d i t_> i r a x a l O
ditiragalong	d i t_> i r a x a l O N
ditirelo	d i t_> i r E l O
ditirisanommogo	d i t_> i r i s a n O m m O x O
ditiriso	d i t_> i r i s O
ditiro	d i t_> i r O
ditirong	d i t_> i r O N
ditirwana	d i t_> i r w a n a
ditlabelo	d i tl_> a b E l O
ditlaleletsa	d i tl_> a l E l E ts_> a
ditlaleletsi	d i tl_> a l E l E ts_> i
ditlaleletso	d i tl_> a l E l E ts_> O
ditlamelo	d i tl_> a m E l O
ditlamo	d i tl_> a m O
ditlamorago	d i tl_> a m O r a x O
ditlankana	d i tl_> a n k_> a n a
ditlha	d i tl_h a
ditlhaeletsano	d i tl_h a E l E ts_> a n O
ditlhagiso	d i tl_h a x i s O
ditlhagiswa	d i tl_h a x i s w a
ditlhaka	d i tl_h a k_> a
ditlhakaina	d i tl_h a k_> a i n a
ditlhakakgolo	d i tl_h a k_> a kx O l O
ditlhakatlhake	d i tl_h a k_> a tl_h a k_> E
ditlhako	d i tl_h a k_> O
ditlhale	d i tl_h a l E
ditlhaloso	d i tl_h a l O s O
ditlhamo	d i tl_h a m O
ditlhangwa	d i tl_h a N w a
ditlhangweng	d i tl_h a N w E N
ditlhapi	d i tl_h a p_> i
ditlhare	d i tl_h a r E
ditlhatlhamano	d i tl_h a tl_h a m a n O
ditlhatlhamanong	d i tl_h a tl_h a m a n O N
ditlhatlhobo	d i tl_h a tl_h O b O
ditlhogo	d i tl_h O x O
ditlhogwana	d i tl_h O x w a n a
ditlhokego	d i tl_h O k_> E x O
ditlhokwa	d i tl_h O k_> w a
ditlhopha	d i tl_h O p_h a
ditlhophanyana	d i tl_h O p_h a J a n a
ditlhopheng	d i tl_h O p_h E N
ditlhopho	d i tl_h O p_h O
ditlhotlhomiso	d i tl_h O tl_h O m i s O
ditlhotlhwa	d i tl_h O tl_h w a
ditlhotshwana	d i tl_h O ts_h w a n a
ditlhwatlhwa	d i tl_h w a tl_h w a
ditlolomolao	d i tl_> O l O m O l a O
ditlomolao	d i tl_> O m O l a O
ditlotla	d i tl_> O tl_> a
ditlwaelo	d i tl_> w a E l O
ditlwaelong	d i tl_> w a E l O N
ditogwa	d i t_> O x w a
ditokafatso	d i t_> O k_> a f a ts_> O
ditokololo	d i t_> O k_> O l O l O
ditokomane	d i t_> O k_> O m a n E
ditopotuelo	d i t_> O p_> O t_> u E l O
ditphate	d i t_> p_h a t_> E
ditrelo	d i t_> r E l O
ditsabakedi	d i ts_> a b a k_> E d i
ditsala	d i ts_> a l a
ditsamaiso	d i ts_> a m a i s O
ditsebe	d i ts_> E b E
ditsela	d i ts_> E l a
ditselafefong	d i ts_> E l a f E f O N
ditseleng	d i ts_> E l E N
ditshedi	d i ts_h E d i
ditshedinyana	d i ts_h E d i J a n a
ditshekatsheko	d i ts_h E k_> a ts_h E k_> O
ditshelete	d i ts_h E l E t_> E
ditshenekegi	d i ts_h E n E k_> E x i
ditshenyegelo	d i ts_h E J E x E l O
ditshepiso	d i ts_h E p_> i s O
ditshiamelo	d i ts_h i a m E l O
ditshiamiso	d i ts_h i a m i s O
ditshono	d i ts_h O n O
ditshupapele	d i ts_h u p_> a p_> E l E
ditshupo	d i ts_h u p_> O
ditshwaelo	d i ts_h w a E l O
ditshwaetso	d i ts_h w a E ts_> O
ditshwanelo	d i ts_h w a n E l O
ditshwantsho	d i ts_h w a n ts_h O
ditshwantshotshupetso	d i ts_h w a n ts_h O ts_h u p_> E ts_> O
ditshweetso	d i ts_h w E E ts_> O
ditshwetso	d i ts_h w E ts_> O
ditshweu	d i ts_h w E u
ditsibogo	d i ts_> i b O x O
ditsidifatsi	d i ts_> i d i f a ts_> i
ditso	d i ts_> O
ditsobotla	d i ts_> O b O tl_> a
ditswatemong	d i ts_> w a t_> E m O N
ditue	d i t_> u E
dituelelothuto	d i t_> u E l E l O t_h u t_> O
dituelo	d i t_> u E l O
ditumalano	d i t_> u m a l a n O
ditumelelano	d i t_> u m E l E l a n O
ditumelelo	d i t_> u m E l E l O
ditumelo	d i t_> u m E l O
ditšhaba	d i tS_h a b a
ditšhate	d i tS_h a t_> E
ditšhelete	d i tS_h E l E t_> E
ditšhono	d i tS_h O n O
diura	d i u r a
diureng	d i u r E N
divideyo	d i i d E j O
divisa	d i i s a
diwebosaete	d i w E b O s a E t_> E
diwebosaeteng	d i w E b O s a E t_> E N
diyamaleng	d i j a m a l E N
diyantle	d i j a n tl_> E
diyuniti	d i j u n i t_> i
dišatlelle	d i S a tl_> E l l E
dna	d i E n E
dna	d n a
doh	d E
doh	d O h
domestic	d E m E s t_h i k_h
dora	d E r E
dora	d O r a
drake	d r a k_> E
drake	d r E k_h
dti	d t_> i
dtlaleletsa	d tl_> a l E l E ts_> a
dubakana	d u b a k_> a n a
duedisa	d u E d i s a
duedisiwang	d u E d i s i w a N
duela	d u E l a
duelang	d u E l a N
duelelwa	d u E l E l w a
duelelwe	d u E l E l w E
duelwa	d u E l w a
duelwang	d u E l w a N
duelwe	d u E l w E
duetse	d u E ts_> E
duetswe	d u E ts_> w E
duetsweng	d u E ts_> w E N
dulang	d u l a N
dule	d u l E
dumalane	d u m a l a n E
dumela	d u m E l a
dumelaneng	d u m E l a n E N
dumelang	d u m E l a N
dumele	d u m E l E
dumelele	d u m E l E l E
dumeleleng	d u m E l E l E N
dumelelwa	d u m E l E l w a
dumelelwang	d u m E l E l w a N
dumelesegeng	d u m E l E s E x E N
dumeletse	d u m E l E ts_> E
dumeletsweng	d u m E l E ts_> w E N
dumelwang	d u m E l w a N
dumetse	d u m E ts_> E
duncan	d a n k_h E n
durban	d a b E n
durban	d u r b a n
dutch	d a tS_h
dwaf	d i d a b E l j u E E f
dwaf	d w a f
e	i
ea	E a
early	a l i
early	E a r l j
east	E a s t_>
east	i s t_h
eastern	E a s t_> E r n
eastern	i s t_h E n
ebile	E b i l E
ecdc	E k_h d k_h
ecdc	i s i d i s i
economic	i k_h E n O m i k_h
economies	i k_h O n E m i s
economy	i k_h O n E m i
edileng	E d i l E N
education	E d_0Z u k_h E s E n
edwin	E d w E n
edwin	E d w i n
ee	E E
efe	E f E
efiling	E f i l i N
eighteenth	E i x h t_> E E n t_h
eighteenth	E t_h i n f
eighty	E i x h t_> j
eighty	E t_h i
ela	E l a
elatlhoko	E l a tl_h O k_> O
ele	E l E
elected	i l E k_h t_h E d
electron	i l E k_h t_h r O n
eleketeroniki	E l E k_> E t_> E r O n i k_> i
elelwa	E l E l w a
eleng	E l E N
eletsa	E l E ts_> a
eletsang	E l E ts_> a N
eletse	E l E ts_> E
elizabeth	i l E s E b E f
elwa	E l w a
ema	E m a
embali	E m b a l i
embasi	E m b a s i
embasing	E m b a s i N
eme	E m E
emeilatsa	E m E i l a ts_> a
emeile	E m E i l E
emeileng	E m E i l E N
emela	E m E l a
emelela	E m E l E l a
emelwa	E m E l w a
emeng	E m E N
emetse	E m E ts_> E
emetseng	E m E ts_> E N
emirates	E m E r E t_h s
emirates	E m i r a t_> E s
emisa	E m i s a
emise	E m i s E
emiseditswe	E m i s E d i ts_> w E
emiseditsweng	E m i s E d i ts_> w E N
emisediwa	E m i s E d i w a
emisetsa	E m i s E ts_> a
emisitseng	E m i s i ts_> E N
emisitswe	E m i s i ts_> w E
emmanuele	E m m a n u E l E
emperors	E m p_> E r O r
emperors	E m p_h E r E s
empire	E m p_h a E r
empire	E m p_> i r E
ena	E n a
ene	E n E
eneji	E n E d_0Z i
energy	E n E d_0Z i
energy	E n E r j
eng	E N
engineering	E n d_0Z i n E r i N
engineering	E N i n E E r i N
england	E N l a n d
england	i N l E n d
englane	E N l a n E
english	E N l i s
english	i N l i s
enjene	E n d_0Z E n E
enjine	E n d_0Z i n E
enke	E n k_> E
eno	E n O
eo	E O
epe	E p_> E
episcopal	E p_h E s k_h E p_h E l
era	E r a
era	E r E
esele	E s E l E
eseng	E s E N
esi	E s i
eskom	E s k_> O m
established	E s t_> a b l i s E d
established	i s t_h a b l i s t_h
eta	E t_> a
etegeditse	E t_> E x E d i ts_> E
etela	E t_> E l a
eteletseng	E t_> E l E ts_> E N
etelwang	E t_> E l w a N
etla	E tl_> a
etsang	E ts_> a N
etse	E ts_> E
etsho	E ts_h O
etsisang	E ts_> i s a N
etswe	E ts_> w E
eu	E u
eu	i j u
evaton	E a t_> O n
evaton	i f E t_h E n
exchange	E k_h s tS_h E n d_0Z
extension	E k_h s t_h E n s E n
extension	E t_> E n s i O n
f	E f
fa	f a
fact	f a k_h t_h
faela	f a E l a
faele	f a E l E
faeleng	f a E l E N
faeliwa	f a E l i w a
faeliwang	f a E l i w a N
faeliwe	f a E l i w E
faelwa	f a E l w a
faelwe	f a E l w E
faene	f a E n E
fale	f a l E
fam	f a m
fang	f a N
fano	f a n O
fantasy	f a n t_> a s j
fantasy	f a n t_h E s i
fao	E f E O
fao	f a O
faphegileng	f a p_h E x i l E N
fapogela	f a p_> O x E l a
fapogelwa	f a p_> O x E l w a
farm	f a m
farm	f a r m
farologana	f a r O l O x a n a
farologanale	f a r O l O x a n a l E
farologane	f a r O l O x a n E
farologaneng	f a r O l O x a n E N
farologantsha	f a r O l O x a n ts_h a
farologantshang	f a r O l O x a n ts_h a N
farologanyang	f a r O l O x a J a N
fatima	f a t_> i m a
fatlhosa	f a tl_h O s a
fatshe	f a ts_h E
fatsheng	f a ts_h E N
fe	E f i
fe	f E
federal	f E d E r a l
federal	f E d E r E l
fedile	f E d i l E
fedileng	f E d i l E N
fedisa	f E d i s a
fediseng	f E d i s E N
feditse	f E d i ts_> E
feke	f E k_> E
fekesa	f E k_> E s a
fekese	f E k_> E s E
fekse	f E k_> E
fela	f E l a
felaboitshimololedi	f E l a b O i ts_h i m O l O l E d i
felelang	f E l E l a N
felele	f E l E l E
felelela	f E l E l E l a
feleletsa	f E l E l E ts_> a
feleletseng	f E l E l E ts_> E N
feleltsang	f E l E l ts_> a N
felelwe	f E l E l w E
feletseng	f E l E ts_> E N
felo	f E l O
ferikgong	f E r i kx O N
feta	f E t_> a
fetang	f E t_> a N
fete	f E t_> E
fetela	f E t_> E l a
fetelang	f E t_> E l a N
fetele	f E t_> E l E
feteletseng	f E t_> E l E ts_> E N
feteng	f E t_> E N
fetesiwa	f E t_> E s i w a
fetileng	f E t_> i l E N
fetisa	f E t_> i s a
fetisang	f E t_> i s a N
fetisediwa	f E t_> i s E d i w a
fetisetsa	f E t_> i s E ts_> a
fetisiwa	f E t_> i s i w a
fetofileng	f E t_> O f i l E N
fetoga	f E t_> O x a
fetogang	f E t_> O x a N
fetogele	f E t_> O x E l E
fetola	f E t_> O l a
fetolang	f E t_> O l a N
fetole	f E t_> O l E
fetolela	f E t_> O l E l a
fetolelwe	f E t_> O l E l w E
fetolwa	f E t_> O l w a
fetotswe	f E t_> O ts_> w E
fetotsweng	f E t_> O ts_> w E N
fiction	f i k_h s E n
filimi	f i l i m i
filimileng	f i l i m i l E N
film	f E l m
film	f i l m
filwe	f i l w E
filweng	f i l w E N
first	f a s t_h
first	f i r t_>
fisika	f i s i k_> a
fitlha	f i tl_h a
fitlhegileng	f i tl_h E x i l E N
fitlhela	f i tl_h E l a
fitlhele	f i tl_h E l E
fitlhelela	f i tl_h E l E l a
fitlhelelang	f i tl_h E l E l a N
fitlhelele	f i tl_h E l E l E
fitlhelelwe	f i tl_h E l E l w E
fitlheletswe	f i tl_h E l E ts_> w E
fitlhelwa	f i tl_h E l w a
fitlhelwang	f i tl_h E l w a N
fitlhetse	f i tl_h E ts_> E
fitlhetseng	f i tl_h E ts_> E N
fitlhile	f i tl_h i l E
fiwa	f i w a
fiwang	f i w a N
fiwe	f i w E
flat	f l a t_>
flat	f l a t_h
florence	f l O r E n s
florida	f l O r i d a
florida	f l O r i d E
fnb	E f E n b i
fofa	f O f a
fofele	f O f E l E
fokodiwa	f O k_> O d i w a
fokotsa	f O k_> O ts_> a
fokotse	f O k_> O ts_> E
folaga	f O l a x a
foleng	f O l E N
following	f O l l O w i N
following	f O l O i N
fologa	f O l O x a
fologelang	f O l O x E l a N
foo	f O O
football	f O O t_> b a l l
football	f u t_h b O l
foramo	f O r a m O
force	f O s
forces	f O s E s
ford	f O d
ford	f O r d
forensiki	f O r E n s i k_> i
forms	f O m s
forms	f O r m
foromo	f O r O m O
foromokopo	f O r O m O k_> O p_> O
foromokopong	f O r O m O k_> O p_> O N
foromong	f O r O m O N
fortress	f O r t_> r E s
fortress	f O t_h r E s
forty	f O r t_> j
forty	f O t_h i
fosagatse	f O s a x a ts_> E
fosagetseng	f O s a x E ts_> E N
foseditse	f O s E d i ts_> E
foundation	f a n d E s E n
foundation	f O u n d a t_> i O n
francis	f r a n s E s
free	f r E E
free	f r i
freedom	f r E E d O m
freedom	f r i d E m
french	f r E n tS_h
ft	E f t_h i
ft	f t_>
fudiseng	f u d i s E N
fudugela	f u d u x E l a
function	f a N k_h s E n
fundamental	f a n d E m E n t_h E l
fundamental	f u n d a m E n t_> a l
g	d_0Z i
ga	x a
gaabo	x a b O
gaaboyoo	x a b O j O O
gabatshwane	x a b a ts_h w a n E
gabedi	x a b E d i
gabo	x a b O
gabosela	x a b O s E l a
gadikega	x a d i k_> E x a
gadima	x a d i m a
gadimile	x a d i m i l E
gae	x a E
gaeng	x a E N
gaeno	x a E n O
gago	x a x O
gagwe	x a x w E
gaisa	x a i s a
gaiseng	x a i s E N
gakanega	x a k_> a n E x a
gaketse	x a k_> E ts_> E
gakologelwa	x a k_> O l O x E l w a
gakolola	x a k_> O l O l a
gala	k_> a l E
gala	x a l a
gale	k_> a l
gale	x a l E
galena	x a l E n a
galeyo	x a l E j O
gama	x a m a
gammogo	x a m m O x O
gana	x a n a
gane	x a n E
ganelela	x a n E l E l a
ganetsa	x a n E ts_> a
ganetsana	x a n E ts_> a n a
ganetse	x a n E ts_> E
gangwe	x a N w E
ganne	x a n n E
gannwe	x a n n w E
ganong	x a n O N
gantsi	x a n ts_> i
ganyesa	x a J E s a
gape	k_> E p_h
gape	x a p_> E
gapelediwa	x a p_> E l E d i w a
gapeletsega	x a p_> E l E ts_> E x a
gaphiri	x a p_h i r i
gararo	x a r a r O
gare	x a r E
gareg	x a r E x
gareng	x a r E N
gase	x a s E
gatakakile	x a t_> a k_> a k_> i l E
gatelela	x a t_> E l E l a
gatelelang	x a t_> E l E l a N
gateletswe	x a t_> E l E ts_> w E
gatetseng	x a t_> E ts_> E N
gatisa	x a t_> i s a
gatise	x a t_> i s E
gatisitseng	x a t_> i s i ts_> E N
gatisitsweng	x a t_> i s i ts_> w E N
gatisiwa	x a t_> i s i w a
gaufi	x a u f i
gauteng	x a u t_> E N
gcis	d_0Z i s i a E s
gcis	s E s
gdp	d_0Z i d i p_h i
gdp	x d p_>
gee	d_0Z i
gee	x E E
gems	d_0Z m s
gems	x E m
gene	d_0Z i n
gene	x E n E
general	d_0Z E n r E l
general	x E n E r a l
genome	d_0Z i n O m
genome	x E n O m E
george	d_0Z O d_0Z
george	x E O r E
german	d_0Z a m E n
german	x E r m a n
germany	d_0Z a m E n i
germany	x E r m a J
germiston	d_0Z a m E s t_h E n
germiston	x E r m i s t_> O n
ghanzi	k_> E n s a
gi	x i
giants	d_0Z a E n t_h s
giants	x i a n ts_>
glucose	k_> l u k_h O s
go	k_> O
go	x O
gobatsang	x O b a ts_> a N
gobeleleng	x O b E l E l E N
goboka	x O b O k_> a
godile	x O d i l E
godimo	x O d i m O
godisa	x O d i s a
godisang	x O d i s a N
godisiwa	x O d i s i w a
goeletsa	x O E l E ts_> a
goga	x O x a
gogang	x O x a N
gogelwe	x O x E l w E
gogeng	x O x E N
gogilwe	x O x i l w E
gogiwa	x O x i w a
gogiwang	x O x i w a N
gognwe	x O x n w E
gogwa	x O x w a
gola	x O l a
golagana	x O l a x a n a
golaganngwang	x O l a x a n N w a N
golang	x O l a N
gole	x O l E
golefapha	x O l E f a p_h a
golo	x O l O
golola	x O l O l a
gololela	x O l O l E l a
gololwa	x O l O l w a
gomadirelo	x O m a d i r E l O
gomotsa	x O m O ts_> a
gompieno	x O m p_> i E n O
gona	x O n a
gone	k_> O n
gone	x O n E
gonetefatsagorebats	x O n E t_> E f a ts_> a x O r E b a ts_>
gongwe	x O N w E
gonne	x O n n E
gontse	x O n ts_> E
gontsintsi	x O n ts_> i n ts_> i
gonwe	x O n w E
good	k_> u d
good	x O O d
gopane	x O p_> a n E
gope	x O p_> E
gopola	x O p_> O l a
gopolelwa	x O p_> O l E l w a
gopoleng	x O p_> O l E N
gore	k_> O r
gore	x O r E
goreke	x O r E k_> E
goreng	x O r E N
goroga	x O r O x a
gorogile	x O r O x i l E
gose	x O s E
gotlhe	x O tl_h E
gotlhelele	x O tl_h E l E l E
gotshwaediwa	x O ts_h w a E d i w a
gouteng	x O u t_> E N
government	k_> a f E n m E n t_h
government	x O E r n m E n t_>
goyang	x O j a N
great	k_> r E t_h
great	x r E a t_>
gross	k_> r O s
gross	x r O s
groups	k_> r u p_h s
groups	x r O u p_>
growth	k_> r O f
growth	x r O w t_h
gulf	k_> a l f
gulf	x u l f
gweba	x w E b a
h	E tS_h
habakgotsamots	h a b a kx O ts_> a m O ts_>
hae	h a E
hague	h a x u E
hall	h a l l
hall	h O l
hamburg	h a m b a k_>
hamburg	h a m b u r
harry	h a r i
harry	h a r r j
he	h E
he	h i
hee	h E E
heela	h E E l a
heelang	h E E l a N
hei	h E i
hemela	h E m E l a
heroene	h E r O E n E
hip	h i p_>
hip	h i p_h
hirilweng	h i r i l w E N
hisetori	h i s E t_> O r i
hisibotlheba	h i s i b O tl_h E b a
hisigoreangwanaotshwanetsego	h i s i x O r E a N w a n a O ts_h w a n E ts_> E x O
hisijwasets	h i s i d_0Z w a s E ts_>
hisiyootshwanetsengripotoeejalo	h i s i j O O ts_h w a n E ts_> E N r i p_> O t_> O E E d_0Z a l O
historic	h i s t_h O r i k_h
history	h i s t_h r i
history	h i s t_> O r j
hiv	h i
ho	h O
hockey	h O k_h i
holy	h O l i
holy	h O l j
home	h O m
home	h O m E
hoodia	h O O d i a
hop	h O p_>
hop	h O p_h
horizontal	h O r i s O n t_h E l
hosetele	h O s E t_> E l E
hot	h O t_>
hot	h O t_h
hubedu	h u b E d u
hudusa	h u d u s a
human	h j u m E n
human	h u m a n
human	j u m E n
humiseng	h u m i s E N
huts	h a t_h s
huts	h u ts_>
i	a
icasa	a k_h E s E
icd	a k_h d
id	i d
idc	i d k_h
idp	i d p_>
iec	a i s i
ii	a a
ii	i i
iii	a a a
iii	i i i
ija	i d_0Z a
ijesa	i d_0Z E s a
ijo	i d_0Z O
ijoo	i d_0Z O O
ijoowee	i d_0Z O O w E E
ik	i k_>
ikaegile	i k_> a E x i l E
ikaegileng	i k_> a E x i l E N
ikaelang	i k_> a E l a N
ikaelela	i k_> a E l E l a
ikaelelang	i k_> a E l E l a N
ikaelele	i k_> a E l E l E
ikaelelwang	i k_> a E l E l w a N
ikaeletse	i k_> a E l E ts_> E
ikaeletseng	i k_> a E l E ts_> E N
ikaeletswe	i k_> a E l E ts_> w E
ikaeletsweng	i k_> a E l E ts_> w E N
ikageng	i k_> a x E N
ikamanya	i k_> a m a J a
ikana	i k_> a n a
ikanela	i k_> a n E l a
ikanetsweng	i k_> a n E ts_> w E N
ikanya	i k_> a J a
ikanyegang	i k_> a J E x a N
ikarabelela	i k_> a r a b E l E l a
ikatisa	i k_> a t_> i s a
ikemetseng	i k_> E m E ts_> E N
iketle	i k_> E tl_> E
iketse	i k_> E ts_> E
ikganetso	i kx a n E ts_> O
ikgatholosa	i kx a t_h O l O s a
ikgatile	i kx a t_> i l E
ikgodisa	i kx O d i s a
ikgolaganya	i kx O l a x a J a
ikgolaganyang	i kx O l a x a J a N
ikgolaganye	i kx O l a x a J E
ikgomotseng	i kx O m O ts_> E N
ikhutse	i k_h u ts_> E
ikitsiso	i k_> i ts_> i s O
ikobela	i k_> O b E l a
ikobele	i k_> O b E l E
ikonomi	i k_> O n O m i
ikopanya	i k_> O p_> a J a
ikutlwa	i k_> u tl_> w a
ikwadisa	i k_> w a d i s a
ikwadise	i k_> w a d i s E
ikwadisetsa	i k_> w a d i s E ts_> a
ikwadisetswang	i k_> w a d i s E ts_> w a N
ikwadisitseng	i k_> w a d i s i ts_> E N
ikwadisiwa	i k_> w a d i s i w a
ikwadiso	i k_> w a d i s O
ile	i l E
ilediwa	i l E d i w a
ilediwang	i l E d i w a N
ileketeroniki	i l E k_> E t_> E r O n i k_> i
imifino	i m i f i n O
imileng	i m i l E N
in	i n
ina	i n a
indaba	i n d a b a
indaseteri	i n d a s E t_> E r i
index	i n d E
index	i n d E k_h s
india	i n d E
india	i n d i a
indian	i n d E n
indian	i n d i a n
indies	i n d i E s
indies	i n d i s
inela	i n E l a
infant	i n f a n t_>
infant	i n f E n t_h
inorense	i n O r E n s E
intaseteri	i n t_> a s E t_> E r i
intelligence	i n t_h E l i d_0Z E n s
interference	i n t_h E f E r E n s
international	i n t_> E r n a t_> i O n a l
international	i n t_h E n a s E n E l
internet	i n t_> E r n E t_>
internet	i n t_h E r n E t_h
inthanete	i n t_h a n E t_> E
inthaneteng	i n t_h a n E t_> E N
intshwarela	i n ts_h w a r E l a
intshwarele	i n ts_h w a r E l E
intshwareleng	i n ts_h w a r E l E N
iowa	a E w E
iowa	i O w a
ipaakanyetse	i p_> a k_> a J E ts_> E
ipabalelo	i p_> a b a l E l O
ipabaleo	i p_> a b a l E O
ipatlela	i p_> a tl_> E l a
ipatlele	i p_> a tl_> E l E
ipega	i p_> E x a
ipege	i p_> E x E
iphitlhela	i p_h i tl_h E l a
ipolaela	i p_> O l a E l a
ipolaya	i p_> O l a j a
ipoleletse	i p_> O l E l E ts_> E
ipona	i p_> O n a
iponele	i p_> O n E l E
ipopeng	i p_> O p_> E N
ipotsa	i p_> O ts_> a
iprs	a p_h i a r E s
ipua	i p_> u a
iran	i r a n
iraq	i r a k_h
iraqi	i r a k_h i
irish	a r i s
irish	i r i s
irp	i r p_>
isa	i s a
isagweng	i s a x w E N
isang	i s a N
ise	i s E
isegang	i s E x a N
iseng	i s E N
isitse	i s i ts_> E
isiwa	i s i w a
isiwe	i s i w E
islamic	i s l a m i k_h
isong	i s O N
israel	i s r a E l
israel	i s r E l
iss	i s
it	i t_>
it	i t_h
italian	i t_> a l i a n
italian	i t_h a l E n
italy	i t_> a l j
italy	i t_h E l i
itatola	i t_> a t_> O l a
itatotseng	i t_> a t_> O ts_> E N
itaya	i t_> a j a
itb	i t_> b
iteile	i t_> E i l E
itekanela	i t_> E k_> a n E l a
itekanelang	i t_> E k_> a n E l a N
itekanetse	i t_> E k_> a n E ts_> E
itemogela	i t_> E m O x E l a
itemogelang	i t_> E m O x E l a N
itewa	i t_> E w a
ithabisa	i t_h a b i s a
ithaya	i t_h a j a
ithusang	i t_h u s a N
ithuta	i t_h u t_> a
ithutela	i t_h u t_> E l a
ithuteng	i t_h u t_> E N
ithutileng	i t_h u t_> i l E N
ithutilweng	i t_h u t_> i l w E N
ithutiwa	i t_h u t_> i w a
itirelang	i t_> i r E l a N
itireleng	i t_> i r E l E N
itirelwa	i t_> i r E l w a
itlhakole	i tl_h a k_> O l E
itlhalose	i tl_h a l O s E
itlhamele	i tl_h a m E l E
itlhametsweng	i tl_h a m E ts_> w E N
itlhophela	i tl_h O p_h E l a
itlhophileng	i tl_h O p_h i l E N
itlotlela	i tl_> O tl_> E l a
itoma	i t_> O m a
itse	i ts_> E
itseela	i ts_> E E l a
itsege	i ts_> E x E
itseng	i ts_> E N
itsese	i ts_> E s E
itsesewe	i ts_> E s E w E
itsewe	i ts_> E w E
itseye	i ts_> E j E
itshedisa	i ts_h E d i s a
itshelela	i ts_h E l E l a
itshenyetsa	i ts_h E J E ts_> a
itshepa	i ts_h E p_> a
itshiamisetseng	i ts_h i a m i s E ts_> E N
itshireletso	i ts_h i r E l E ts_> O
itshoke	i ts_h O k_> E
itshokodisetsa	i ts_h O k_> O d i s E ts_> a
itshole	i ts_h O l E
itshwarela	i ts_h w a r E l a
itshwenya	i ts_h w E J a
itsise	i ts_> i s E
itsisetsweng	i ts_> i s E ts_> w E N
itsisiwa	i ts_> i s i w a
itsisiwe	i ts_> i s i w E
itsiwe	i ts_> i w E
itsiweng	i ts_> i w E N
itsoseng	i ts_> O s E N
itumedisa	i t_> u m E d i s a
itumela	i t_> u m E l a
itumelela	i t_> u m E l E l a
itumetse	i t_> u m E ts_> E
iv	i
j	d_0Z E
ja	d_0Z a
jaaka	d_0Z a k_> a
jaana	d_0Z a n a
jaanong	d_0Z a n O N
jaka	d_0Z a k_> a
jale	d_0Z a l E
jalelelwa	d_0Z a l E l E l w a
jalo	d_0Z a l O
jalojalo	d_0Z a l O d_0Z a l O
james	d_0Z a m E s
james	d_0Z E m s
jang	d_0Z a N
jaoka	d_0Z a O k_> a
japane	d_0Z a p_> a n E
je	d_0Z E
jeff	d_0Z E f
jeff	d_0Z E f f
jeke	d_0Z E k_> E
jela	d_0Z E l a
jeppes	d_0Z E p_h i
jeppes	d_0Z E p_> p_> E s
jeriko	d_0Z E r i k_> O
jesa	d_0Z E s a
jeso	d_0Z E s O
jesus	d_0Z E s u s
jesus	d_0Z i s E s
jets	d_0Z E t_h s
jets	d_0Z E ts_>
jetseng	d_0Z E ts_> E N
jimbro	d_0Z i m b r O
jj	d_0Z E d_0Z E
jljl	d_0Z E a l d_0Z E a l
jo	d_0Z O
jogee	d_0Z E d_0Z i
jogee	d_0Z O x E E
johanesburg	d_0Z E h a n E s b a k_>
johanesburg	d_0Z O h a n E s b u r
john	d_0Z O h n
john	d_0Z O n
jole	d_0Z O l E
jona	d_0Z O n a
jonase	d_0Z O n a s E
jone	d_0Z O n E
joo	d_0Z O O
jotlhe	d_0Z O tl_h E
journal	d_0Z a n E l
journal	d_0Z O u r n a l
july	d_0Z u l a
july	d_0Z u l j
junction	d_0Z a N k_h s E n
justice	d_0Z a s t_h E s
juvenal	d_0Z u E n a l
juvenal	d_0Z u f E n E l
jwa	d_0Z w a
jwaneng	d_0Z w a n E N
k	k_h E
ka	k_> a
kabaganyang	k_> a b a x a J a N
kabelo	k_> a b E l O
kabinete	k_> a b i n E t_> E
kabo	k_> a b O
kabogape	k_> a b O x a p_> E
kadimo	k_> a d i m O
kae	k_> a E
kaedi	k_> a E d i
kaela	k_> a E l a
kaelang	k_> a E l a N
kaele	k_> a E l E
kaelo	k_> a E l O
kaelwa	k_> a E l w a
kaelwang	k_> a E l w a N
kafa	k_> a f a
kaga	k_> a x a
kagego	k_> a x E x O
kagiso	k_> a x i s O
kago	k_> a x O
kagong	k_> a x O N
kagosea	k_> a x O s E a
kailwe	k_> a i l w E
kailweng	k_> a i l w E N
kaiwang	k_> a i w a N
kakanyo	k_> a k_> a J O
kakaretso	k_> a k_> a r E ts_> O
kalafi	k_> a l a f i
kalafo	k_> a l a f O
kalafong	k_> a l a f O N
kalo	k_> a l O
kalogo	k_> a l O x O
kamano	k_> a m a n O
kamego	k_> a m E x O
kamete	k_> a m E t_> E
kamo	k_> a m O
kamogelo	k_> a m O x E l O
kamoreng	k_> a m O r E N
kampanang	k_> a m p_> a n a N
kana	k_> a n a
kanamiso	k_> a n a m i s O
kanamo	k_> a n a m O
kanana	k_> a n a n a
kananyo	k_> a n a J O
kanelang	k_> a n E l a N
kanetsweng	k_> a n E ts_> w E N
kang	k_> a N
kanisitsweng	k_> a n i s i ts_> w E N
kanisiwa	k_> a n i s i w a
kankere	k_> a n k_> E r E
kannwe	k_> a n n w E
kannweng	k_> a n n w E N
kantoro	k_> a n t_> O r O
kantorong	k_> a n t_> O r O N
kao	k_> a O
kao	k_h O
kaoto	k_> a O t_> O
kapa	k_> a p_> a
kapitale	k_> a p_> i t_> a l E
kapodiso	k_> a p_> O d i s O
karabo	k_> a r a b O
karata	k_> a r a t_> a
karateng	k_> a r a t_> E N
karatšheng	k_> a r a tS_h E N
karetsa	k_> a r E ts_> a
karo	k_> a r O
karoganyo	k_> a r O x a J O
karolelo	k_> a r O l E l O
karolo	k_> a r O l O
karologanyetso	k_> a r O l O x a J E ts_> O
karologanyo	k_> a r O l O x a J O
karolong	k_> a r O l O N
karolothuto	k_> a r O l O t_h u t_> O
karolwana	k_> a r O l w a n a
kaseteng	k_> a s E t_> E N
katisiwa	k_> a t_> i s i w a
katiso	k_> a t_> i s O
katlaatlegoloago	k_> a tl_> a tl_> E x O l O a x O
katlego	k_> a tl_> E x O
katlholo	k_> a tl_h O l O
katoloso	k_> a t_> O l O s O
katoloswa	k_> a t_> O l O s w a
katso	k_> a ts_> O
kaya	k_> a j a
kayang	k_> a j a N
ke	k_> E
kedi	k_> E d i
kedisaletse	k_> E d i s a l E ts_> E
keiti	k_> E i t_> i
keledi	k_> E l E d i
keletso	k_> E l E ts_> O
kelotlhoko	k_> E l O tl_h O k_> O
kemedi	k_> E m E d i
kemelo	k_> E m E l O
kemetseng	k_> E m E ts_> E N
kemiso	k_> E m i s O
kemisong	k_> E m i s O N
kemo	k_> E m O
kemonokeng	k_> E m O n O k_> E N
kemonosi	k_> E m O n O s i
keng	k_> E N
kennedy	k_> E n n E d j
kennedy	k_h E n E d i
kerafo	k_> E r a f O
kereite	k_> E r E i t_> E
kereiti	k_> E r E i t_> i
keresete	k_> E r E s E t_> E
kerileng	k_> E r i l E N
keteka	k_> E t_> E k_> a
ketekima	k_> E t_> E k_> i m a
keteko	k_> E t_> E k_> O
ketelo	k_> E t_> E l O
ketleetso	k_> E tl_> E E ts_> O
ketlolaketlola	k_> E tl_> O l a k_> E tl_> O l a
ketshepamang	k_> E ts_h E p_> a m a N
ketsisa	k_> E ts_> i s a
key	k_> E j
key	k_h i
kgabaganya	kx a b a x a J a
kgabaganyang	kx a b a x a J a N
kgabaganyo	kx a b a x a J O
kgabanya	kx a b a J a
kgabele	kx a b E l E
kgabetsa	kx a b E ts_> a
kgaisano	kx a i s a n O
kgaitsadi	kx a i ts_> a d i
kgaitsadiake	kx a i ts_> a d i a k_> E
kgakala	kx a k_> a l a
kgakololo	kx a k_> O l O l O
kgale	kx a l E
kgalemo	kx a l E m O
kganelang	kx a n E l a N
kganelo	kx a n E l O
kgang	kx a N
kgano	kx a n O
kgaogana	kx a O x a n a
kgaoganang	kx a O x a n a N
kgaogane	kx a O x a n E
kgaoganeng	kx a O x a n E N
kgaoganngwa	kx a O x a n N w a
kgaoganngwe	kx a O x a n N w E
kgaogantsweng	kx a O x a n ts_> w E N
kgaoganye	kx a O x a J E
kgaoganyo	kx a O x a J O
kgaola	kx a O l a
kgaolo	kx a O l O
kgaolong	kx a O l O N
kgaotsa	kx a O ts_> a
kgapela	kx a p_> E l a
kgapetsa	kx a p_> E ts_> a
kgapetsakgapetsa	kx a p_> E ts_> a kx a p_> E ts_> a
kgapetswe	kx a p_> E ts_> w E
kgara	kx a r a
kgaratlhang	kx a r a tl_h a N
kgaso	kx a s O
kgatelelo	kx a t_> E l E l O
kgathalela	kx a t_h a l E l a
kgathalesege	kx a t_h a l E s E x E
kgatiso	kx a t_> i s O
kgatisogape	kx a t_> i s O x a p_> E
kgatisomenwa	kx a t_> i s O m E n w a
kgatisosebedi	kx a t_> i s O s E b E d i
kgatlhanong	kx a tl_h a n O N
kgatlhegelang	kx a tl_h E x E l a N
kgatlhegelong	kx a tl_h E x E l O N
kgatlhego	kx a tl_h E x O
kgatlhegong	kx a tl_h E x O N
kgato	kx a t_> O
kgatong	kx a t_> O N
kgature	kx a t_> u r E
kgelelo	kx E l E l O
kgerisa	kx E r i s a
kgetha	kx E t_h a
kgethegileng	kx E t_h E x i l E N
kgethileng	kx E t_h i l E N
kgetho	kx E t_h O
kgethololo	kx E t_h O l O l O
kgetsana	kx E ts_> a n a
kgetse	kx E ts_> E
kgetsi	kx E ts_> i
kgobalo	kx O b a l O
kgobalong	kx O b a l O N
kgobokanya	kx O b O k_> a J a
kgobokanyo	kx O b O k_> a J O
kgodiso	kx O d i s O
kgodisong	kx O d i s O N
kgodumodumo	kx O d u m O d u m O
kgoeletso	kx O E l E ts_> O
kgogamasigo	kx O x a m a s i x O
kgogometso	kx O x O m E ts_> O
kgokagano	kx O k_> a x a n O
kgokgole	kx O kx O l E
kgokgotsho	kx O kx O ts_h O
kgolagano	kx O l a x a n O
kgolegelong	kx O l E x E l O N
kgolo	kx O l O
kgologolo	kx O l O x O l O
kgololesego	kx O l O l E s E x O
kgololo	kx O l O l O
kgololosego	kx O l O l O s E x O
kgolong	kx O l O N
kgolwane	kx O l w a n E
kgomarela	kx O m a r E l a
kgomaretsa	kx O m a r E ts_> a
kgomo	kx O m O
kgona	kx O n a
kgonagalang	kx O n a x a l a N
kgonagale	kx O n a x a l E
kgonagalo	kx O n a x a l O
kgonang	kx O n a N
kgone	kx O n E
kgonega	kx O n E x a
kgonegang	kx O n E x a N
kgonne	kx O n n E
kgono	kx O n O
kgontsha	kx O n ts_h a
kgopolo	kx O p_> O l O
kgopololo	kx O p_> O l O l O
kgoreletsa	kx O r E l E ts_> a
kgoreletso	kx O r E l E ts_> O
kgoro	kx O r O
kgorong	kx O r O N
kgosi	kx O s i
kgosomano	kx O s O m a n O
kgotla	kx O tl_> a
kgotlang	kx O tl_> a N
kgotlapeomolao	kx O tl_> a p_> E O m O l a O
kgotlatshekelo	kx O tl_> a ts_h E k_> E l O
kgotlatshekelokgolo	kx O tl_> a ts_h E k_> E l O kx O l O
kgotlatshekelong	kx O tl_> a ts_h E k_> E l O N
kgotlelelo	kx O tl_> E l E l O
kgotleng	kx O tl_> E N
kgotlhang	kx O tl_h a N
kgotlhelo	kx O tl_h E l O
kgotsa	kx O ts_> a
kgotsake	kx O ts_> a k_> E
kgotsofaditswe	kx O ts_> O f a d i ts_> w E
kgotsofadiwe	kx O ts_> O f a d i w E
kgotsofalela	kx O ts_> O f a l E l a
kgotsofalele	kx O ts_> O f a l E l E
kgotsofatsa	kx O ts_> O f a ts_> a
kgotsofatsang	kx O ts_> O f a ts_> a N
kgotsofetse	kx O ts_> O f E ts_> E
kgotsong	kx O ts_> O N
kgr	k_h E d_0Z i a r
kgwa	kx w a
kgwebo	kx w E b O
kgweboa	kx w E b O a
kgwebong	kx w E b O N
kgwedi	kx w E d i
kgwedithataro	kx w E d i t_h a t_> a r O
kgweetsa	kx w E E ts_> a
kgweetsang	kx w E E ts_> a N
kgwele	kx w E l E
kgwetlho	kx w E tl_h O
kgwetlhong	kx w E tl_h O N
khabara	k_h a b a r a
khabareng	k_h a b a r E N
khamphane	k_h a m p_h a n E
khansela	k_h a n s E l a
khansele	k_h a n s E l E
khaontareng	k_h a O n t_> a r E N
kharikhulamo	k_h a r i k_h u l a m O
kharikhulamong	k_h a r i k_h u l a m O N
khasekete	k_h a s E k_> E t_> E
khatekori	k_h a t_> E k_> O r i
khemera	k_h E m E r a
khemisitiri	k_h E m i s i t_> i r i
khidiega	k_h i d i E x a
khokheine	k_h O k_h E i n E
kholera	k_h O l E r a
kholomo	k_h O l O m O
kholomong	k_h O l O m O N
khomešiale	k_h O m E S i a l E
khomisene	k_h O m i s E n E
khomišene	k_h O m i S E n E
khomphutareng	k_h O m p_h u t_> a r E N
khomputara	k_h O m p_> u t_> a r a
khophi	k_h O p_h i
khophing	k_h O p_h i N
khopi	k_h O p_> i
khopikgolo	k_h O p_> i kx O l O
khoutu	k_h O u t_> u
khudugo	k_h u d u x O
khukhwane	k_h u k_h w a n E
khuma	k_h u m a
khumo	k_h u m O
khunwana	k_h u n w a n a
khutla	k_h u tl_> a
khutlisa	k_h u tl_> i s a
khutlisiwa	k_h u tl_> i s i w a
khutlonne	k_h u tl_> O n n E
khutlopono	k_h u tl_> O p_> O n O
khutshwane	k_h u ts_h w a n E
khutso	k_h u ts_> O
khutswafaditsweng	k_h u ts_> w a f a d i ts_> w E N
khutswafatso	k_h u ts_> w a f a ts_> O
khutswafatswang	k_h u ts_> w a f a ts_> w a N
khwaere	k_h w a E r E
kidibatso	k_> i d i b a ts_> O
kile	k_> i l E
kileng	k_> i l E N
kiletsong	k_> i l E ts_> O N
kima	k_> i m a
kimana	k_> i m a n a
kimberley	k_h i m b E l i
kimberley	k_> i m b E r l E j
king	k_h i N
king	k_> i N
kingdom	k_h i N d E m
kingdom	k_> i N d O m
kippur	k_> i p_> p_> u r
kitla	k_> i tl_> a
kitlang	k_> i tl_> a N
kitsiso	k_> i ts_> i s O
kitso	k_> i ts_> O
ko	k_h E O
ko	k_> O
koafatsang	k_> O a f a ts_> a N
koafatse	k_> O a f a ts_> E
kobileng	k_> O b i l E N
kobilweng	k_> O b i l w E N
kobo	k_h E b E
kobo	k_> O b O
koketsegong	k_> O k_> E ts_> E x O N
koketso	k_> O k_> E ts_> O
kokoanngwa	k_> O k_> O a n N w a
kokoantsweng	k_> O k_> O a n ts_> w E N
kokoanya	k_> O k_> O a J a
kokoanyo	k_> O k_> O a J O
kokobatsa	k_> O k_> O b a ts_> a
kolo	k_> O l O
kolobetso	k_> O l O b E ts_> O
koloi	k_> O l O i
kolotwang	k_> O l O t_> w a N
komiti	k_> O m i t_> i
komiting	k_> O m i t_> i N
komišeneng	k_> O m i S E n E N
konokono	k_> O n O k_> O n O
konosediwa	k_> O n O s E d i w a
konosetsa	k_> O n O s E ts_> a
konotelela	k_> O n O t_> E l E l a
konotetsa	k_> O n O t_> E ts_> a
konteraka	k_> O n t_> E r a k_> a
konti	k_> O n t_> i
kontinente	k_> O n t_> i n E n t_> E
kontinenteng	k_> O n t_> i n E n t_> E N
koo	k_> O O
kopa	k_> O p_> a
kopana	k_> O p_> a n a
kopaneng	k_> O p_> a n E N
kopanetse	k_> O p_> a n E ts_> E
kopanetsweng	k_> O p_> a n E ts_> w E N
kopang	k_> O p_> a N
kopanngwang	k_> O p_> a n N w a N
kopanngwe	k_> O p_> a n N w E
kopano	k_> O p_> a n O
kopanong	k_> O p_> a n O N
kopantsha	k_> O p_> a n ts_h a
kopanyang	k_> O p_> a J a N
kope	k_> O p_> E
kopela	k_> O p_> E l a
kopelo	k_> O p_> E l O
kopetsweng	k_> O p_> E ts_> w E N
kopetswengcc	k_h O p_h E t_h s w E n k_h
kopi	k_> O p_> i
kopile	k_> O p_> i l E
kopileng	k_> O p_> i l E N
kopilwe	k_> O p_> i l w E
kopilweng	k_> O p_> i l w E N
kopiwa	k_> O p_> i w a
kopiwang	k_> O p_> i w a N
kopmane	k_> O p_> m a n E
kopo	k_> O p_> O
kopong	k_> O p_> O N
koporasi	k_> O p_> O r a s i
korong	k_> O r O N
kotane	k_> O t_> a n E
kotlhao	k_> O tl_h a O
kotlhaong	k_> O tl_h a O N
kotsa	k_> O ts_> a
kotsi	k_> O ts_> i
kotsing	k_> O ts_> i N
kumo	k_> u m O
kuranteng	k_> u r a n t_> E N
kutlopono	k_> u tl_> O p_> O n O
kutlwano	k_> u tl_> w a n O
kutlwelobotlhoko	k_> u tl_> w E l O b O tl_h O k_> O
kutlwiso	k_> u tl_> w i s O
kwa	k_> w a
kwadileng	k_> w a d i l E N
kwadilwe	k_> w a d i l w E
kwadilweng	k_> w a d i l w E N
kwadisa	k_> w a d i s a
kwadisang	k_> w a d i s a N
kwadisetsa	k_> w a d i s E ts_> a
kwadisitsw	k_> w a d i s i ts_> w
kwadisitswe	k_> w a d i s i ts_> w E
kwadisitsweng	k_> w a d i s i ts_> w E N
kwadisiwa	k_> w a d i s i w a
kwadisiwang	k_> w a d i s i w a N
kwadiso	k_> w a d i s O
kwadiwa	k_> w a d i w a
kwadiwe	k_> w a d i w E
kwala	k_> w a l a
kwale	k_> w a l E
kwalela	k_> w a l E l a
kwalelano	k_> w a l E l a n O
kwalelwa	k_> w a l E l w a
kwalo	k_> w a l O
kwalolola	k_> w a l O l O l a
kwalololo	k_> w a l O l O l O
kwalwa	k_> w a l w a
kwalwang	k_> w a l w a N
kwalwe	k_> w a l w E
kwana	k_> w a n a
kwano	k_> w a n O
kwantle	k_> w a n tl_> E
kwao	k_> w a O
kwatlhao	k_> w a tl_h a O
kyi	k_h E w a a
kyi	k_> j i
l	a l
la	l a
labile	l a b i l E
labobedi	l a b O b E d i
labone	l a b O n E
laboraro	l a b O r a r O
labotlhano	l a b O tl_h a n O
lacking	l a k_h i N
laden	l a d E n
laden	l E d E n
laeborari	l a E b O r a r i
laela	l a E l a
laesense	l a E s E n s E
laesesnse	l a E s E s n s E
laetsweng	l a E ts_> w E N
lago	l a x O
laiwa	l a i w a
lak	l a k_>
lakab	l a k_> a b
lakabaaan	l a k_> a b a n
lakaban	l a k_> a b a n
lakabane	l a k_> a b a n E
lakbi	l a k_> b i
lala	l a l a
land	l a n d
lange	l a N E
language	l a N k_> w i d_0Z
language	l a N u a x E
laola	l a O l a
laolang	l a O l a N
laolegang	l a O l E x a N
laolwa	l a O l w a
laolwang	l a O l w a N
laotsweng	l a O ts_> w E N
lapeng	l a p_> E N
lapologa	l a p_> O l O x a
largest	l a d_0Z E s t_h
largest	l a r E s t_>
larry	l a r i
larry	l a r r j
late	l a t_> E
late	l E t_h
latela	l a t_> E l a
latelana	l a t_> E l a n a
latelanang	l a t_> E l a n a N
latelang	l a t_> E l a N
latele	l a t_> E l E
latelwa	l a t_> E l w a
latelwang	l a t_> E l w a N
latetse	l a t_> E ts_> E
latetswe	l a t_> E ts_> w E
latlha	l a tl_h a
latlhabololo	l a tl_h a b O l O l O
latlhege	l a tl_h E x E
latlhegelwa	l a tl_h E x E l w a
latlhegelwe	l a tl_h E x E l w E
latlhegetswe	l a tl_h E x E ts_> w E
latlhiwa	l a tl_h i w a
latofadiwa	l a t_> O f a d i w a
latofadiwang	l a t_> O f a d i w a N
law	l a w
law	l O
lawrence	l O r E n s
laya	l a j a
le	l E
leaders	l E a d E r
leaders	l i d E s
league	l E a x u E
league	l i k_>
leano	l E a n O
leba	l E b a
lebagana	l E b a x a n a
lebaka	l E b a k_> a
lebakeng	l E b a k_> E N
lebala	l E b a l a
lebale	l E b a l E
lebanese	l E b a n E s E
lebanese	l E b E n i s
lebati	l E b a t_> i
lebating	l E b a t_> i N
lebato	l E b a t_> O
lebelela	l E b E l E l a
lebelelwa	l E b E l E l w a
lebelelwe	l E b E l E l w E
lebeletse	l E b E l E ts_> E
lebeletswe	l E b E l E ts_> w E
lebeletsweng	l E b E l E ts_> w E N
lebelo	l E b E l O
lebenkele	l E b E n k_> E l E
lebenkeleng	l E b E n k_> E l E N
lebile	l E b i l E
lebilwe	l E b i l w E
lebisa	l E b i s a
lebise	l E b i s E
lebiseditswe	l E b i s E d i ts_> w E
lebisitseng	l E b i s i ts_> E N
lebisitsweng	l E b i s i ts_> w E N
lebisitswenggo	l E b i s i ts_> w E N O
leboga	l E b O x a
lebogile	l E b O x i l E
leboko	l E b O k_> O
lebokosong	l E b O k_> O s O N
lebolelamading	l E b O l E l a m a d i N
lebolelateng	l E b O l E l a t_> E N
lebotho	l E b O t_h O
lebotlolo	l E b O tl_> O l O
lebotlolong	l E b O tl_> O l O N
lectures	l E k_h tS_h E s
lediri	l E d i r i
lee's	l i s
leele	l E E l E
lefapha	l E f a p_h a
lefapheng	l E f a p_h E N
lefatshe	l E f a ts_h E
lefatsheng	l E f a ts_h E N
lefaufau	l E f a u f a u
lefe	l E f E
lefelafela	l E f E l a f E l a
lefelo	l E f E l O
lefelobogorogelong	l E f E l O b O x O r O x E l O N
lefelong	l E f E l O N
lefisa	l E f i s a
lefoko	l E f O k_> O
lefuru	l E f u r u
legae	l E x a E
legaeng	l E x a E N
legala	l E x a l a
legano	l E x a n O
legare	l E x a r E
legato	l E k_> E t_h O
legato	l E x a t_> O
legatong	l E x a t_> O N
legodimo	l E x O d i m O
legolo	l E x O l O
leina	l E i n a
leineng	l E i n E N
leitlho	l E i tl_h O
leka	l E k_> a
lekala	l E k_> a l a
lekaleng	l E k_> a l E N
lekana	l E k_> a n a
lekanang	l E k_> a n a N
lekane	l E k_> a n E
lekaneng	l E k_> a n E N
lekanyeditsweng	l E k_> a J E d i ts_> w E N
lekanyediwang	l E k_> a J E d i w a N
lekanyediwe	l E k_> a J E d i w E
lekanyetsa	l E k_> a J E ts_> a
lekanyetsang	l E k_> a J E ts_> a N
lekanyetse	l E k_> a J E ts_> E
lekanyetswang	l E k_> a J E ts_> w a N
lekase	l E k_> a s E
lekgarebe	l E kx a r E b E
lekgetho	l E kx E t_h O
lekgethong	l E kx E t_h O N
lekgetlho	l E kx E tl_h O
lekgong	l E kx O N
lekgotla	l E kx O tl_> a
lekgotlakatlholong	l E kx O tl_> a k_> a tl_h O l O N
lekgotlana	l E kx O tl_> a n a
lekgotlataolo	l E kx O tl_> a t_> a O l O
lekgotleng	l E kx O tl_> E N
lekgotlha	l E kx O tl_h a
lekoko	l E k_> O k_> O
lekokong	l E k_> O k_> O N
lekwalo	l E k_> w a l O
lekwaloforomo	l E k_> w a l O f O r O m O
lekwaloikitsiso	l E k_> w a l O i k_> i ts_> i s O
lekwaloitshupo	l E k_> w a l O i ts_h u p_> O
lekwalokopo	l E k_> w a l O k_> O p_> O
lekwalong	l E k_> w a l O N
lekwalotetla	l E k_> w a l O t_> E tl_> a
lekwalotshupo	l E k_> w a l O ts_h u p_> O
lekwete	l E k_> w E t_> E
lela	l E l a
lelapa	l E l a p_> a
lelapeng	l E l a p_> E N
lele	l E l E
lelelweng	l E l E l w E N
leleme	l E l E m E
leloko	l E l O k_> O
lelokolegolo	l E l O k_> O l E x O l O
lelokong	l E l O k_> O N
lema	l E m a
lemoga	l E m O x a
lemogile	l E m O x i l E
lemogilwe	l E m O x i l w E
lemogiwa	l E m O x i w a
lemogwa	l E m O x w a
lemosa	l E m O s a
lenaane	l E n a n E
lenaanekatiso	l E n a n E k_> a t_> i s O
lenaanenetefatso	l E n a n E n E t_> E f a ts_> O
lenaaneng	l E n a n E N
lenaga	l E n a x a
lenane	l E n a n E
lenaneng	l E n a n E N
lenaneo	l E n a n E O
lenaneong	l E n a n E O N
lenanepotso	l E n a n E p_> O ts_> O
lenanepotsong	l E n a n E p_> O ts_> O N
lenanetirong	l E n a n E t_> i r O N
lenasia	l E n a s i a
leng	l E N
lengenana	l E N E n a n a
lengole	l E N O l E
lengwe	l E N w E
leno	l E n O
lentle	l E n tl_> E
lentswe	l E n ts_> w E
lenyalo	l E J a l O
lenyalong	l E J a l O N
lenyatso	l E J a ts_> O
leo	l E O
leo	l i O
leofile	l E O f i l E
leoto	l E O t_> O
leotwana	l E O t_> w a n a
lepe	l E p_> E
lephata	l E p_h a t_> a
lephatapotlana	l E p_h a t_> a p_> O tl_> a n a
lephateng	l E p_h a t_> E N
lephatla	l E p_h a tl_> a
lepodisa	l E p_> O d i s a
lepodisi	l E p_> O d i s i
lerapo	l E r a p_> O
lerato	l E r a t_> O
lere	l E r E
lerole	l E r O l E
leroleng	l E r O l E N
lerumo	l E r u m O
leruo	l E r u O
leruri	l E r u r i
lesa	l E s a
lesea	l E s E a
leseanyana	l E s E a J a n a
lesedi	l E s E d i
lesego	l E s E x O
lesetifikheiti	l E s E t_> i f i k_h E i t_> i
lesetlha	l E s E tl_h a
lesole	l E s O l E
lesome	l E s O m E
lesomepedi	l E s O m E p_> E d i
lesope	l E s O p_> E
lesotho	l E s E t_h O
lesotho	l E s O t_h O
leswana	l E s w a n a
leswe	l E s w E
leta	l E t_> a
letamo	l E t_> a m O
lethakane	l E t_h a k_> a n E
lethoro	l E t_h O r O
letileng	l E t_> i l E N
letilwe	l E t_> i l w E
letirelo	l E t_> i r E l O
letla	l E tl_> a
letlalo	l E tl_> a l O
letlametlo	l E tl_> a m E tl_> O
letlang	l E tl_> a N
letlatlana	l E tl_> a tl_> a n a
letlelela	l E tl_> E l E l a
letleleleng	l E tl_> E l E l E N
letlelelwa	l E tl_> E l E l w a
letleletswe	l E tl_> E l E ts_> w E
letleletsweng	l E tl_> E l E ts_> w E N
letlha	l E tl_h a
letlhakeng	l E tl_h a k_> E N
letlhakore	l E tl_h a k_> O r E
letlhakoreng	l E tl_h a k_> O r E N
letlhalosi	l E tl_h a l O s i
letlhare	l E tl_h a r E
letlhareng	l E tl_h a r E N
letlheng	l E tl_h E N
letlhogela	l E tl_h O x E l a
letlhomeso	l E tl_h O m E s O
letlhomesong	l E tl_h O m E s O N
letlole	l E tl_> O l E
letlotlo	l E tl_> O tl_> O
letona	l E t_> O n a
letsapa	l E ts_> a p_> a
letsapanyana	l E ts_> a p_> a J a n a
letsatsi	l E ts_> a ts_> i
letsatsing	l E ts_> a ts_> i N
letseditse	l E ts_> E d i ts_> E
letsele	l E ts_> E l E
letseno	l E ts_> E n O
letseto	l E ts_> E t_> O
letshogo	l E ts_h O x O
letsholo	l E ts_h O l O
letshoroma	l E ts_h O r O m a
letshwalo	l E ts_h w a l O
letshwao	l E ts_h w a O
letshwaokgwebo	l E ts_h w a O kx w E b O
letshwaong	l E ts_h w a O N
letsibogo	l E ts_> i b O x O
letsogo	l E ts_> O x O
letsogong	l E ts_> O x O N
letswalo	l E ts_> w a l O
levels	l E E l
levels	l E f E l s
lewatle	l E w a tl_> E
lexical	l E k_h s i k_h E l
liberal	l E b E r E l
liberal	l i b E r a l
license	l a s E n s
lifelong	l a f l O N
lifelong	l i f E l O N
limited	l E m E t_h E d
limited	l i m i t_> E d
limpopo	l i m p_> O p_> O
lindi	l i n d i
lindley	l E n d l i
lindley	l i n d l E j
link	l i n k_>
link	l i N k_h
list	l E s t_h
list	l i s t_>
lloto	l l O t_> O
lo	l O
loa	l O a
loago	l O a x O
lobaka	l O b a k_> a
lobakanyana	l O b a k_> a J a n a
lobakeng	l O b a k_> E N
lobatse	l O b a ts_> E
lobelo	l O b E l O
lobotaneng	l O b O t_> a n E N
local	l O k_h E l
loeto	l O E t_> O
loetong	l O E t_> O N
logato	l O x a t_> O
logogo	l O x O x O
logolo	l O x O l O
lokgetho	l O kx E t_h O
lokgethong	l O kx E t_h O N
lokwalo	l O k_> w a l O
lokwaloboitshupo	l O k_> w a l O b O i ts_h u p_> O
lokwaloitshupu	l O k_> w a l O i ts_h u p_> u
lokwalotshelo	l O k_> w a l O ts_h E l O
lolamang	l O l a m a N
lolameng	l O l a m E N
lolea	l O l E a
loleme	l O l E m E
lomaganya	l O m a x a J a
lomanyaneng	l O m a J a n E N
lomeletsa	l O m E l E ts_> a
lomeletsang	l O m E l E ts_> a N
lona	l O n a
lonaka	l O n a k_> a
london	l a n d E n
london	l O n d O n
long	l O N
longwe	l O N w E
loo	l O O
loo	l u
lopa	l O p_> a
lora	l O r a
lorato	l O r a t_> O
los	l O s
losea	l O s E a
loseeng	l O s E E N
losi	l O s i
losika	l O s i k_> a
loso	l O s O
losong	l O s O N
lossless	l O s l E s
lotlhe	l O tl_h E
lotseno	l O ts_> E n O
lotsenong	l O ts_> E n O N
lotso	l O ts_> O
lrad	a l a r E d i
lsa	l a
lucky	l a k_h i
lwa	l w a
lwabobedi	l w a b O b E d i
lwela	l w E l a
lydia	l i d E
lydia	l j d i a
m	E m
ma	m a
maaforika	m a f O r i k_> a
maano	m a a n O
maarabia	m a r a b i a
maatla	m a tl_> a
maatlafatso	m a tl_> a f a ts_> O
mabaka	m a b a k_> a
mabakeng	m a b a k_> E N
mabanta	m a b a n t_> a
mabapi	m a b a p_> i
mabati	m a b a t_> i
mabedi	m a b E d i
mabinagotsholwa	m a b i n a x O ts_h O l w a
mabitla	m a b i tl_> a
maboko	m a b O k_> O
mabone	m a b O n E
maboriki	m a b O r i k_> i
mabotlolo	m a b O tl_> O l O
mabotlolong	m a b O tl_> O l O N
madi	m a d i
madibe	m a d i b E
madikwe	m a d i k_> w E
madirelo	m a d i r E l O
madirelong	m a d i r E l O N
madiri	m a d i r i
maduo	m a d u O
madyo	m a d j O
maemedi	m a E m E d i
maemo	m a E m O
maemogodimo	m a E m O x O d i m O
maemoleditsamaiso	m a E m O l E d i ts_> a m a i s O
maemong	m a E m O N
maesimane	m a E s i m a n E
maetla	m a E tl_> a
maeto	m a E t_> O
maetsi	m a E ts_> i
mafapha	m a f a p_h a
mafapheng	m a f a p_h E N
mafaratlhatlha	m a f a r a tl_h a tl_h a
mafaratlhatlheng	m a f a r a tl_h a tl_h E N
mafatlha	m a f a tl_h a
mafatsheng	m a f a ts_h E N
mafega	m a f E x a
mafelo	m a f E l O
mafelobonno	m a f E l O b O n n O
mafelong	m a f E l O N
mafenya	m a f E J a
mafikeng	m a f i k_> E N
mafoko	m a f O k_> O
mafolofolo	m a f O l O f O l O
maforanse	m a f O r a n s E
mafura	m a f u r a
magaeng	m a x a E N
magalapa	m a x a l a p_> a
magareng	m a x a r E N
magiseterata	m a x i s E t_> E r a t_> a
magolo	m a x O l O
magolwane	m a x O l w a n E
mahala	m a h a l a
maikaelelo	m a i k_> a E l E l O
maikano	m a i k_> a n O
maikarabelo	m a i k_> a r a b E l O
maikarebelo	m a i k_> a r E b E l O
maikatlapelo	m a i k_> a tl_> a p_> E l O
maikemisetso	m a i k_> E m i s E ts_> O
maikutlo	m a i k_> u tl_> O
maina	m a i n a
mainamatswa	m a i n a m a ts_> w a
maipato	m a i p_> a t_> O
maipobolo	m a i p_> O b O l O
maitato	m a i t_> a t_> O
maitatolo	m a i t_> a t_> O l O
maiteko	m a i t_> E k_> O
maitekong	m a i t_> E k_> O N
maitemogelo	m a i t_> E m O x E l O
maitemogelong	m a i t_> E m O x E l O N
maitlamo	m a i tl_> a m O
maitlhomo	m a i tl_h O m O
maitlhomong	m a i tl_h O m O N
maitseo	m a i ts_> E O
maitsholo	m a i ts_h O l O
maitshwarelo	m a i ts_h w a r E l O
major	m a d_0Z O r
major	m E d_0Z E r
majwe	m a d_0Z w E
makala	m a k_> a l a
makalela	m a k_> a l E l a
makasine	m a k_> a s i n E
makatsa	m a k_> a ts_> a
makgabaganyo	m a kx a b a x a J O
makgabaganyong	m a kx a b a x a J O N
makgetho	m a kx E t_h O
makgong	m a kx O N
makgotla	m a kx O tl_> a
makgotlatoropo	m a kx O tl_> a t_> O r O p_> O
makgwafo	m a kx w a f O
makgwakgwa	m a kx w a kx w a
makoko	m a k_> O k_> O
makopanelo	m a k_> O p_> a n E l O
makopanelong	m a k_> O p_> a n E l O N
makopanyi	m a k_> O p_> a J i
makwalo	m a k_> w a l O
makwalodikgang	m a k_> w a l O d i kx a N
makwaloitshupo	m a k_> w a l O i ts_h u p_> O
makwalokgang	m a k_> w a l O kx a N
makwalotetla	m a k_> w a l O t_> E tl_> a
makwalothuto	m a k_> w a l O t_h u t_> O
makwalotshupo	m a k_> w a l O ts_h u p_> O
mala	m a l a
malapa	m a l a p_> a
malaria	m a l a r i a
malaria	m E l E r E
malatlhelwa	m a l a tl_h E l w a
malatsi	m a l a ts_> i
malatsing	m a l a ts_> i N
male	m a l E
male	m E l
maleba	m a l E b a
malebana	m a l E b a n a
malepa	m a l E p_> a
maloba	m a l O b a
maloko	m a l O k_> O
malwa	m a l w a
malwetse	m a l w E ts_> E
malyasia	m a l j a s i a
mama	m a m a
mama	m a m E
mamame	m a m a m E
mamaretsa	m a m a r E ts_> a
mamelodi	m a m E l O d i
mametlelelo	m a m E tl_> E l E l O
mametleletswe	m a m E tl_> E l E ts_> w E
mametleletsweng	m a m E tl_> E l E ts_> w E N
manaane	m a n a a n E
manaanepalo	m a n a n E p_> a l O
management	m a n a x E m E n t_>
management	m a n i d_0Z m E n t_h
manane	m a n a n E
mananeng	m a n a n E N
mananeo	m a n a n E O
mane	m a n
mane	m a n E
mang	m a N
mangole	m a N O l E
mangosuthu	m a N O s u t_h u
mangwe	m a N w E
mankwe	m a n k_> w E
manokonoko	m a n O k_> O n O k_> O
mantle	m a n t_h E l
mantle	m a n tl_> E
manxa	m a n a
manyako	m a J a k_> O
manyalong	m a J a l O N
manyualeng	m a J u a l E N
maokelo	m a O k_> E l O
maoto	m a O t_> O
maparego	m a p_> a r E x O
maphata	m a p_h a t_> a
maphodisa	m a p_h O d i s a
maphodiseng	m a p_h O d i s E N
maplasing	m a p_> l a s i N
mapodisi	m a p_> O d i s i
mapula	m a p_> u l a
maragong	m a r a x O N
marakanelo	m a r a k_> a n E l O
marakanelong	m a r a k_> a n E l O N
marapo	m a r a p_> O
mararo	m a r a r O
marašia	m a r a S i a
marble	m a b E l
marble	m a r b l E
marcel	m a s E l
march	m a tS_h
mareo	m a r E O
marine	m a r i n E
marine	m E r i n
marinini	m a r i n i n i
market	m a k_h E t_h
market	m a r k_> E t_>
marobalo	m a r O b a l O
martha	m a r t_h a
martha	m a t_h h a
martial	m a r t_> i a l
martial	m a s E l
masakaneng	m a s a k_> a n E N
maseka	m a s E k_> a
maseke	m a s E k_> E
masepala	m a s E p_> a l a
maseru	m a s E r u
mashi	m a s i
masigo	m a s i x O
masilo	m a s i l O
masimo	m a s i m O
masisi	m a s i s i
masked	m a s k_> E d
masked	m a s k_h t_h
masube	m a s u b E
masuputso	m a s u p_> u ts_> O
maswabi	m a s w a b i
maswanganyi	m a s w a N a J i
maswaswa	m a s w a s w a
maswe	m a s w E
maswi	m a s w i
matamo	m a t_> a m O
materiki	m a t_> E r i k_> i
mathaithai	m a t_h a i t_h a i
mathata	m a t_h a t_> a
mathateng	m a t_h a t_> E N
matheriale	m a t_h E r i a l E
mathule	m a t_h u l E
mathusamadiri	m a t_h u s a m a d i r i
matikiring	m a t_> i k_> i r i N
matlakala	m a tl_> a k_> a l a
matlha	m a tl_h a
matlhaa	m a tl_h a a
matlhabisaditlhong	m a tl_h a b i s a d i tl_h O N
matlhagatlhaga	m a tl_h a x a tl_h a x a
matlhaka	m a tl_h a k_> a
matlhakore	m a tl_h a k_> O r E
matlhale	m a tl_h a l E
matlhalosi	m a tl_h a l O s i
matlhano	m a tl_h a n O
matlhaodi	m a tl_h a O d i
matlhare	m a tl_h a r E
matlho	m a tl_h O
matlholaadibona	m a tl_h O l a d i b O n a
matlhomeso	m a tl_h O m E s O
matlhophi	m a tl_h O p_h i
matlo	m a tl_> O
matloane	m a tl_> O a n E
matlole	m a tl_> O l E
matlolo	m a tl_> O l O
matlosana	m a tl_> O s a n a
matlosane	m a tl_> O s a n E
matlotlo	m a tl_> O tl_> O
matsalo	m a ts_> a l O
matsapa	m a ts_> a p_> a
matsatsi	m a ts_> a ts_> i
matsenong	m a ts_> E n O N
matsetela	m a ts_> E t_> E l a
matsetseleko	m a ts_> E ts_> l E k_> O
matshediso	m a ts_h E d i s O
matshelo	m a ts_h E l O
matsheloa	m a ts_h E l O a
matshwafo	m a ts_h w a f O
matshwanedi	m a ts_h w a n E d i
matshwao	m a ts_h w a O
matshwaokgwebo	m a ts_h w a O kx w E b O
matshwaopuiso	m a ts_h w a O p_> u i s O
matshwenedi	m a ts_h w E n E d i
matso	m a ts_> O
matsogo	m a ts_> O x O
matsogong	m a ts_> O x O N
matswakabele	m a ts_> w a k_> a b E l E
matswalo	m a ts_> w a l O
matšhaena	m a tS_h a E n a
matšhini	m a tS_h i n i
maudi	m a u d i
mawatle	m a w a tl_> E
max	m a
max	m a k_h s
maxi	m a i
maxwell	m a k_h s w E l
maxwell	m a w E l l
may	m a j
may	m E
mašwi	m a S w i
mbete	m b E t_> E
mbpm	E m b i p_h i E m
mdda	E m d i d i E
me	m E
me	m i
mebila	m E b i l a
mec	m E k_h
medi	m E d i
medicine	m E d s E n
mediro	m E d i r O
medumo	m E d u m O
meepo	m E E p_> O
meepong	m E E p_> O N
meetlo	m E E tl_> O
mefuta	m E f u t_> a
mefutafuta	m E f u t_> a f u t_> a
mefutafuteng	m E f u t_> a f u t_> E N
mefutapuo	m E f u t_> a p_> u O
megala	m E x a l a
megare	m E x a r E
megatla	m E x a tl_> a
megodungwana	m E x O d u N w a n a
mekgatlho	m E kx a tl_h O
mekgatlo	m E kx a tl_> O
mekgwa	m E kx w a
mekhutshwane	m E k_h u ts_h w a n E
melaetsa	m E l a E ts_> a
melao	m E l a O
melato	m E l a t_> O
melawana	m E l a w a n a
melbourne	m E l b O n
melbourne	m E l b O u r n E
melelo	m E l E l O
melelwane	m E l E l w a n E
melemo	m E l E m O
meletlo	m E l E tl_> O
member	m E m b E r
members	m E m b E r
members	m E m b E s
memorantamo	m E m O r a n t_> a m O
menape	m E n a p_> E
mene	m E n E
mengwe	m E N w E
menkgo	m E n kx O
meno	m E n O
menontsha	m E n O n ts_h a
menontshetsong	m E n O n ts_h E ts_> O N
mentsi	m E n ts_> i
menwana	m E n w a n a
meraba	m E r a b a
merafe	m E r a f E
merero	m E r E r O
merogo	m E r O x O
mesifa	m E s i f a
mesola	m E s O l a
meteme	m E t_> E m E
methalethale	m E t_h a l E t_h a l E
metheo	m E t_h E O
methodist	m E f E d E s t_h
methodist	m E t_h O d i s t_>
metlae	m E tl_> a E
metlha	m E tl_h a
metlhagare	m E tl_h a x a r E
metric	m E t_h r i k_h
metro	m E t_h r O
metro	m E t_> r O
mets	m E t_h s
mets	m E ts_>
metsa	m E ts_> a
metse	m E ts_> E
metsengselegae	m E ts_> E N E l E x a E
metshameko	m E ts_h a m E k_> O
metsi	m E ts_> i
metsing	m E ts_> i N
metsotso	m E ts_> O ts_> O
metsotswana	m E ts_> O ts_> w a n a
metswedi	m E ts_> w E d i
metsweding	m E ts_> w E d i N
metšhine	m E tS_h i n E
middle	m E d E l
middle	m i d d l E
midrand	m E d r a n d
midrand	m i d r a n d
military	m i l i t_> a r j
military	m i l i t_h r i
million	m i l E n
million	m i l l i O n
minerale	m i n E r a l E
minerals	m E n E r E l s
minerals	m i n E r a l
minister	m E n E s t_h E r
minister	m i n i s t_> E r
mintech	m E n t_h E k_h
mitolente	m i t_> O l E n t_> E
mitshini	m i ts_h i n i
mixed	m i E d
mixed	m i k_h s t_h
mma	m m a
mmaabo	m m a b O
mmaago	m m a x O
mmaagwe	m m a x w E
mmabatho	m m a b a t_h O
mmaetsho	m m a E ts_h O
mmagisetera	m m a x i s E t_> E r a
mmagiseterata	m m a x i s E t_> E r a t_> a
mmakgomotso	m m a kx O m O ts_> O
mmala	m m a l a
mmalabadi	m m a l a b a d i
mmalo	m m a l O
mmaloo	m m a l O O
mmalooo	m m a l O O O
mmalwa	m m a l w a
mmalwanyana	m m a l w a J a n a
mmamasilanoka	m m a m a s i l a n O k_> a
mmamoruti	m m a m O r u t_> i
mmamotia	m m a m O t_> i a
mmapule	m m a p_> u l E
mmasepala	m m a s E p_> a l a
mmathando	m m a t_h a n d O
mmatla	m m a tl_> a
mmatladi	m m a tl_> a d i
mmatlela	m m a tl_> E l a
mmatota	m m a t_> O t_> a
mmatsalaagwe	m m a ts_> a l a x w E
mmatšhatšhi	m m a tS_h a tS_h i
mmawena	m m a w E n a
mme	m m E
mmelaelwa	m m E l a E l w a
mmele	m m E l E
mmelege	m m E l E x E
mmelegi	m m E l E x i
mmelegisi	m m E l E x i s i
mmeleng	m m E l E N
mmemme	m m E m m E
mmemogoyonagodirwatogamaanoyagorengwanaotla	m m E m O x O j O n a x O d i r w a t_> O x a m a n O j a x O r E N w a n a O tl_> a
mmese	m m E s E
mmila	m m i l a
mmina	m m i n a
mmino	m m i n O
mmisheneng	m m i s E n E N
mmishineng	m m i s i n E N
mmitolente	m m i t_> O l E n t_> E
mmm	E m E m E m
mmm	m
mmoelwa	m m O E l w a
mmogedi	m m O x E d i
mmogo	m m O x O
mmoki	m m O k_> i
mmolai	m m O l a i
mmoledi	m m O l E d i
mmona	m m O n a
mmone	m m O n E
mmopimoromelatengmoagi	m m O p_> i m O r O m E l a t_> E N m O a x i
mmotlana	m m O tl_> a n a
mmu	m m u
mmuela	m m u E l a
mmueledi	m m u E l E d i
mmueleding	m m u E l E d i N
mmui	m m u i
mmuisano	m m u i s a n O
mmuletse	m m u l E ts_> E
mmung	m m u N
mmusakgotla	m m u s a kx O tl_> a
mmuso	m m u s O
mmutlwa	m m u tl_> w a
mo	m O
moabi	m O a b i
moaforika	m O a f O r i k_> a
moagi	m O a x i
moago	m O a x O
moakanyetso	m O a k_> a J E ts_> O
moakhaefe	m O a k_h a E f E
moakhaefeng	m O a k_h a E f E N
moalong	m O a l O N
moamogedi	m O a m O x E d i
moamogeladitshwanelo	m O a m O x E l a d i ts_h w a n E l O
moapaya	m O a p_> a j a
moatemerale	m O a t_> E m E r a l E
moatlhodi	m O a tl_h O d i
moatlhosi	m O a tl_h O s i
moboregadiri	m O b O r E x a d i r i
mobothani	m O b O t_h a n i
mocks	m O k_h s
model	m O d E l
modimo	m O d i m O
modiragatsi	m O d i r a x a ts_> i
modirakopo	m O d i r a k_> O p_> O
modiramolato	m O d i r a m O l a t_> O
modiredi	m O d i r E d i
modirelwa	m O d i r E l w a
modiri	m O d i r i
modirimmogo	m O d i r i m m O x O
modirisi	m O d i r i s i
modiro	m O d i r O
modirsi	m O d i r i
modisa	m O d i s a
modise	m O d i s E
modudi	m O d u d i
moduedi	m O d u E d i
moduelalekgetho	m O d u E l a l E kx E t_h O
modulasetilo	m O d u l a s E t_> i l O
modulasetulo	m O d u l a s E t_> u l O
modumo	m O d u m O
moemedi	m O E m E d i
moeng	m O E N
moento	m O E n t_> O
moepo	m O E p_> O
moepong	m O E p_> O N
moetapele	m O E t_> a p_> E l E
moeteledipele	m O E t_> E l E d i p_> E l E
moeteledipelenyana	m O E t_> E l E d i p_> E l E J a n a
mofatlhosi	m O f a tl_h O s i
mofuta	m O f u t_> a
mogakolodi	m O x a k_> O l O d i
mogala	m O x a l a
mogalammakapaa	m O x a l a m m a k_> a p_> a
mogaleng	m O x a l E N
mogare	m O x a r E
mogatsa	m O x a ts_> a
mogatsaaka	m O x a ts_> a k_> a
mogatsaake	m O x a ts_> a k_> E
mogatsaka	m O x a ts_> a k_> a
mogatsake	m O x a ts_> a k_> E
mogatse	m O x a ts_> E
mogobe	m O x O b E
mogodu	m O x O d u
mogodungwana	m O x O d u N w a n a
mogogoro	m O x O x O r O
mogokaganyi	m O x O k_> a x a J i
mogokgo	m O x O kx O
mogolegwa	m O x O l E x w a
mogolo	m O x O l O
mogolole	m O x O l O l E
mogolong	m O x O l O N
mogoloo	m O x O l O O
mogopolo	m O x O p_> O l O
mogoteng	m O x O t_> E N
mogwase	m O x w a s E
mogwebisani	m O x w E b i s a n i
moh	m O h
mohiri	m O h i r i
moi	m O i
moikaegi	m O i k_> a E x i
moikanisi	m O i k_> a n i s i
moikarabedi	m O i k_> a r a b E d i
moipolai	m O i p_> O l a i
moithuti	m O i t_h u t_> i
moitseanape	m O i ts_> E a n a p_> E
moja	m O d_0Z a
mojeng	m O d_0Z E N
mojeoloji	m O d_0Z E O l O d_0Z i
moji	m O d_0Z i
mojule	m O d_0Z u l E
mokaedi	m O k_> a E d i
mokaedikakaretso	m O k_> a E d i k_> a k_> a r E ts_> O
mokapelo	m O k_> a p_> E l O
mokemise	m O k_> E m i s E
mokgadi	m O kx a d i
mokgalajwe	m O kx a l a d_0Z w E
mokgatlho	m O kx a tl_h O
mokgatlhong	m O kx a tl_h O N
mokgatlo	m O kx a tl_> O
mokgotlhwane	m O kx O tl_h w a n E
mokgwa	m O kx w a
mokgweetsi	m O kx w E E ts_> i
mokgweng	m O kx w E N
mokhonto	m O k_h O n t_> O
mokhuduthamaga	m O k_h u d u t_h a m a x a
moko	m O k_> O
mokoa	m O k_> O a
mokokotlo	m O k_> O k_> O tl_> O
mokolela	m O k_> O l E l a
mokomisinara	m O k_> O m i s i n a r a
mokomišenara	m O k_> O m i S E n a r a
mokonteraka	m O k_> O n t_> E r a k_> a
mokopa	m O k_> O p_> a
mokopatshireletso	m O k_> O p_> a ts_h i r E l E ts_> O
mokopi	m O k_> O p_> i
mokoro	m O k_> O r O
mokotso	m O k_> O ts_> O
mokua	m O k_> u a
mokwadi	m O k_> w a d i
mokwadise	m O k_> w a d i s E
mokwadisi	m O k_> w a d i s i
mokwaledi	m O k_> w a l E d i
mokwalo	m O k_> w a l O
mokwatleng	m O k_> w a tl_> E N
mokwena	m O k_> w E n a
mola	m O l a
molaedi	m O l a E d i
molao	m O l a O
molaodi	m O l a O d i
molaodimogolo	m O l a O d i m O x O l O
molaong	m O l a O N
molaotheo	m O l a O t_h E O
molaotlamo	m O l a O tl_> a m O
molaotlhomo	m O l a O tl_h O m O
molato	m O l a t_> O
molatofadiwa	m O l a t_> O f a d i w a
molatswana	m O l a ts_> w a n a
molawana	m O l a w a n a
molawanawa	m O l a w a n a w a
molekane	m O l E k_> a n E
molelwane	m O l E l w a n E
molema	m O l E m a
molemeng	m O l E m E N
molemikalona	m O l E m i k_> a l O n a
molemirui	m O l E m i r u i
molemo	m O l E m O
molemong	m O l E m O N
moleng	m O l E N
moletlo	m O l E tl_> O
moletsatsing	m O l E ts_> a ts_> i N
molomo	m O l O m O
molora	m O l O r a
moloreng	m O l O r E N
monate	m O n a t_> E
monday	m a n d E
monday	m O n d a j
monetetshi	m O n E t_> E ts_h i
monetshi	m O n E ts_h i
mong	m O N
mongongoregi	m O N O N O r E x i
mongwe	m O N w E
monjobi	m O n d_0Z O b i
monna	m O n n a
monnamogolo	m O n n a m O x O l O
monnasetilo	m O n n a s E t_> i l O
monngwe	m O n N w E
monni	m O n n i
monning	m O n n i N
monnye	m O n J E
mono	m E n O
mono	m O n O
monongwaga	m O n O N w a x a
monontsha	m O n O n ts_h a
montle	m O n tl_> E
montshiwa	m O n ts_h i w a
montsho	m O n ts_h O
montshwa	m O n ts_h w a
montsi	m O n ts_> i
montšhwa	m O n tS_h w a
monwana	m O n w a n a
monyana	m O J a n a
moo	m O O
moo	m u
mookamedi	m O O k_> a m E d i
mooki	m O O k_> i
mopagami	m O p_> a x a m i
mopeleto	m O p_> E l E t_> O
mophasalatsi	m O p_h a s a l a ts_> i
mophimola	m O p_h i m O l a
mopitlwe	m O p_> i tl_> w E
moporesidente	m O p_> O r E s i d E n t_> E
moporesitente	m O p_> O r E s i t_> E n t_> E
moputso	m O p_> u ts_> O
moraba	m O r a b a
morafe	m O r a f E
morago	m O r a x O
moranang	m O r a n a N
morasefe	m O r a s E f E
moratiwa	m O r a t_> i w a
moratwe	m O r a t_> w E
more	m O r
more	m O r E
moreetsa	m O r E E ts_> a
morekisi	m O r E k_> i s i
moremi	m O r E m i
morena	m O r E n a
moreneng	m O r E n E N
morero	m O r E r O
morerong	m O r E r O N
moretele	m O r E t_> E l E
morethetho	m O r E t_h E t_h O
moribo	m O r i b O
morogo	m O r O x O
moroko	m O r O k_> O
morokotso	m O r O k_> O ts_> O
morokweng	m O r O k_> w E N
moromelateng	m O r O m E l a t_> E N
morongwa	m O r O N w a
moroto	m O r O t_> O
mortality	m O r t_> a l i t_> j
mortality	m O t_h a l E t_h i
morulaganyi	m O r u l a x a J i
morule	m O r u l E
moruleng	m O r u l E N
morumo	m O r u m O
moruni	m O r u n i
morutabana	m O r u t_> a b a n a
moruti	m O r u t_> i
morwa	m O r w a
morwadia	m O r w a d i a
morwadie	m O r w a d i E
morwadio	m O r w a d i O
morwae	m O r w a E
morwalo	m O r w a l O
morwarra	m O r w a r r a
morwarre	m O r w a r r E
mosadi	m O s a d i
mosadimogolo	m O s a d i m O x O l O
mose	m O s E
moseja	m O s E d_0Z a
mosekaphofu	m O s E k_> a p_h O f u
mosekaseki	m O s E k_> a s E k_> i
mosenogi	m O s E n O x i
mosepele	m O s E p_> E l E
moses	m O s E s
mosese	m O s E s E
mosetsana	m O s E ts_> a n a
mosi	m O s i
mosidi	m O s i d i
mosimane	m O s i m a n E
mosimanyana	m O s i m a J a n a
mosime	m O s i m E
mosireletsi	m O s i r E l E ts_> i
mosola	m O s O l a
mosupi	m O s u p_> i
mosupologo	m O s u p_> O l O x O
moswagadi	m O s w a x a d i
moswelwa	m O s w E l w a
mosweu	m O s w E u
moswi	m O s w i
moswinini	m O s w i n i n i
mothabela	m O t_h a b E l a
mothale	m O t_h a l E
mothapi	m O t_h a p_> i
mothaping	m O t_h a p_> i N
mothapiwa	m O t_h a p_> i w a
mothati	m O t_h a t_> i
mothelesi	m O t_h E l E s i
mothelesing	m O t_h E l E s i N
motheo	m O t_h E O
motheong	m O t_h E O N
motho	m O t_h O
mothofatso	m O t_h O f a ts_> O
mothong	m O t_h O N
mothusa	m O t_h u s a
mothusamotlhankedi	m O t_h u s a m O tl_h a n k_> E d i
mothusi	m O t_h u s i
motlakase	m O tl_> a k_> a s E
motlamedi	m O tl_> a m E d i
motlatsa	m O tl_> a ts_> a
motlatsamodulasetulo	m O tl_> a ts_> a m O d u l a s E t_> u l O
motlatsamogokgo	m O tl_> a ts_> a m O x O kx O
motlha	m O tl_h a
motlhagolatsela	m O tl_h a x O l a ts_> E l a
motlhakanelwa	m O tl_h a k_> a n E l w a
motlhakedi	m O tl_h a k_> E d i
motlhala	m O tl_h a l a
motlhale	m O tl_h a l E
motlhaleng	m O tl_h a l E N
motlhami	m O tl_h a m i
motlhaneng	m O tl_h a n E N
motlhang	m O tl_h a N
motlhankedi	m O tl_h a n k_> E d i
motlhankeding	m O tl_h a n k_> E d i N
motlhankela	m O tl_h a n k_> E l a
motlhatlhaobi	m O tl_h a tl_h a O b i
motlhatlhobi	m O tl_h a tl_h O b i
motlhatlhobiwa	m O tl_h a tl_h O b i w a
motlhofo	m O tl_h O f O
motlhokomedi	m O tl_h O k_> O m E d i
motlhokomelwa	m O tl_h O k_> O m E l w a
motlholagadi	m O tl_h O l a x a d i
motlhomaganya	m O tl_h O m a x a J a
motlhophi	m O tl_h O p_h i
motlola	m O tl_> O l a
motlolamolao	m O tl_> O l a m O l a O
motor	m O t_h E r
motor	m O t_> O r
motorokara	m O t_> O r O k_> a r a
motsadi	m O ts_> a d i
motsamaisi	m O ts_> a m a i s i
motsamayakadinao	m O ts_> a m a j a k_> a d i n a O
motse	m O ts_> E
motseleganyi	m O ts_> E l E x a J i
motseletsele	m O ts_> E l E ts_> E l E
motseneledi	m O ts_> E n E l E d i
motseng	m O ts_> E N
motsereganyi	m O ts_> E r E x a J i
motsesetoropo	m O ts_> E s E t_> O r O p_> O
motshabi	m O ts_h a b i
motshameko	m O ts_h a m E k_> O
motshamekong	m O ts_h a m E k_> O N
motshegang	m O ts_h E x a N
motsheganong	m O ts_h E x a n O N
motshegare	m O ts_h E x a r E
motshelo	m O ts_h E l O
motshepagang	m O ts_h E p_> a x a N
motshiwa	m O ts_h i w a
motshodi	m O ts_h O d i
motsofe	m O ts_> O f E
motsotso	m O ts_> O ts_> O
motsu	m O ts_> u
motswa	m O ts_> w a
motswako	m O ts_> w a k_> O
motswantle	m O ts_> w a n tl_> E
motswasetlhabelo	m O ts_> w a s E tl_h a b E l O
motswedi	m O ts_> w E d i
motsweding	m O ts_> w E d i N
motšhoni	m O tS_h O n i
mount	m a n t_h
mount	m O u n t_>
mouwane	m O u w a n E
movement	m O E m E n t_>
movement	m u f m E n t_h
mowa	m O w a
moša	m O S a
mošantowe	m O S a n t_> O w E
moše	m O S E
mošwa	m O S w a
mpa	m p_> a
mpatla	m p_> a tl_> a
mphenya	m p_h E J a
mpho	m p_h O
mphodi	m p_h O d i
mponeng	m p_> O n E N
music	m j u s i k_h
musical	m j u s i k_h E l
na	E n E
na	n a
naare	n a r E
nababet	n a b a b E t_>
nabo	n a b O
nae	n a E
nafu	n a f u
naga	n a x a
nagana	n a x a n a
naganang	n a x a n a N
nageng	n a x E N
nako	n a k_> O
nakong	n a k_> O N
nakwana	n a k_> w a n a
nala	n a l a
naledi	n a l E d i
nama	n a m a
namane	n a m a n E
namela	n a m E l a
namolo	n a m O l O
namune	n a m u n E
naneofatsa	n a n E O f a ts_> a
nang	n a N
nao	n a O
nashville	n a s f E l
nashville	n a s i l l E
natala	n a t_> a l a
national	n a s E n E l
national	n a t_> i O n a l
nations	n a t_> i O n s
nations	n E s E n s
natla	n a tl_> a
nato	n a t_> O
nato	n E t_h O
natso	n a ts_> O
natswe	n a ts_> w E
natural	n a tS_h r E l
natural	n a t_> u r a l
naval	n a a l
naval	n E f E l
navy	n a j
navy	n E f i
naya	n a j a
nayang	n a j a N
nayo	n a j O
ncop	E n s i O p_h i
ncop	n k_h O p_h
ncpa	E n s i p_h i E
ncpa	n k_h p_h a
ne	n E
nebula	n E b j u l E
nebula	n E b u l a
neela	n E E l a
neelana	n E E l a n a
neelanang	n E E l a n a N
neelang	n E E l a N
neele	n E E l E
neelo	n E E l O
neelwa	n E E l w a
neelwang	n E E l w a N
neetswe	n E E ts_> w E
neetsweng	n E E ts_> w E N
nef	n E f
neile	n E i l E
neileng	n E i l E N
neilweng	n E i l w E N
nemisa	n E m i s a
neng	n E N
nenga	n E N a
neo	n E O
neo	n i O
nepagalo	n E p_> a x a l O
nepagetseng	n E p_> a x E ts_> E N
netefaditsweng	n E t_> E f a d i ts_> w E N
netefadiwa	n E t_> E f a d i w a
netefaleditsweng	n E t_> E f a l E d i ts_> w E N
netefatsa	n E t_> E f a ts_> a
netefatsang	n E t_> E f a ts_> a N
netefatse	n E t_> E f a ts_> E
netefatso	n E t_> E f a ts_> O
netefatswang	n E t_> E f a ts_> w a N
network	n E t_h w a k_h
network	n E t_> w O r k_>
new	n E w
new	n j u
newa	n E w a
newcastle	n j u k_h a s E l
neye	n E j E
neyeng	n E j E N
ng	E n d_0Z i
ngaka	N a k_> a
ngakane	N a k_> a n E
ngakeng	N a k_> E N
ngoka	N O k_> a
ngongoreg	N O N O r E x
ngongoregang	N O N O r E x a N
ngongorego	N O N O r E x O
ngwa	N w a
ngwaga	N w a x a
ngwagalengwaga	N w a x a l E N w a x a
ngwagasome	N w a x a s O m E
ngwageng	N w a x E N
ngwana	N w a n a
ngwanaka	N w a n a k_> a
ngwanake	N w a n a k_> E
ngwanatseele	N w a n a ts_> E E l E
ngwanatsele	N w a n a ts_> E l E
ngwao	N w a O
ngwaoboswa	N w a O b O s w a
ngwega	N w E x a
ngwetsi	N w E ts_> i
ni	n i
night	n a t_h
night	n i x h t_>
nixon	n i k_h s E n
nixon	n i O n
njobe	n d_0Z O b E
nka	n k_> a
nkatle	n k_> a tl_> E
nkefi	n k_> E f i
nkeme	n k_> E m E
nkganang	n kx a n a N
nkgomotse	n kx O m O ts_> E
nkgonne	n kx O n n E
nkgopola	n kx O p_> O l a
nkgoreletsa	n kx O r E l E ts_> a
nkinela	n k_> i n E l a
nkinele	n k_> i n E l E
nkitla	n k_> i tl_> a
nkitsing	n k_> i ts_> i N
nko	n k_> O
nku	n k_> u
nkutlwe	n k_> u tl_> w E
nna	n n a
nnaka	n n a k_> a
nnake	n n a k_> E
nnana	n n a n a
nnang	n n a N
nne	n n E
nnela	n n E l a
nnete	n n E t_> E
nngwe	n N w E
nnile	n n i l E
nnileng	n n i l E N
nniwa	n n i w a
nnotagi	n n O t_> a x i
nnyaa	n J a
nnyaya	n J a j a
nnye	n J E
noga	n O x a
noka	n O k_> a
nokana	n O k_> a n a
nokeng	n O k_> E N
nolofatsa	n O l O f a ts_> a
nomalanga	n O m a l a N a
nominations	n O m E n E s E n s
nominations	n O m i n a t_> i O n s
nomore	n O m O r E
nomoro	n O m O r O
nomoropolata	n O m O r O p_> O l a t_> a
nonofile	n O n O f i l E
nonofileng	n O n O f i l E N
nonofo	n O n O f O
norman	n O m E n
norman	n O r m a n
norse	n O r E
norse	n O s
north	n O f
north	n O r t_h
northeastern	n O f i s t_h E n
northeastern	n O r t_h E a s t_> E r n
nosetso	n O s E ts_> O
nosi	n O s i
notary	n O t_> a r j
notary	n O t_h E r i
novels	n O E l
novels	n O f E l s
nt	E n t_h i
nta	n t_> a
ntaoleng	n t_> a O l E N
ntata	n t_> a t_> a
ntataalona	n t_> a t_> a l O n a
ntate	n t_> a t_> E
nte	n t_> E
ntekwane	n t_> E k_> w a n E
nteletsa	n t_> E l E ts_> a
nteng	n t_> E N
nteso	n t_> E s O
ntha	n t_h a
nthatela	n t_h a t_> E l a
ntho	n t_h O
nthola	n t_h O l a
nthwafatso	n t_h w a f a ts_> O
ntla	n tl_> a
ntle	n tl_> E
ntlha	n tl_h a
ntlhake	n tl_h a k_> E
ntlhakgolo	n tl_h a kx O l O
ntlhana	n tl_h a n a
ntlheng	n tl_h E N
ntlhomola	n tl_h O m O l a
ntlo	n tl_> O
ntlokemeding	n tl_> O k_> E m E d i N
ntlokgolo	n tl_> O kx O l O
ntlong	n tl_> O N
ntlwana	n tl_> w a n a
ntlwanaboithusetso	n tl_> w a n a b O i t_h u s E ts_> O
ntope	n t_> O p_> E
ntsaya	n ts_> a j a
ntse	n ts_> E
ntseng	n ts_> E N
ntsenyang	n ts_> E J a N
ntsha	n ts_h a
ntshala	n ts_h a l a
ntshana	n ts_h a n a
ntshe	n ts_h E
ntshegetse	n ts_h E x E ts_> E
ntshetsa	n ts_h E ts_> a
ntshidi	n ts_h i d i
ntshitse	n ts_h i ts_> E
ntshitswe	n ts_h i ts_> w E
ntshitsweng	n ts_h i ts_> w E N
ntshiwa	n ts_h i w a
ntshiwang	n ts_h i w a N
ntshiwe	n ts_h i w E
ntshosetsa	n ts_h O s E ts_> a
ntshuba	n ts_h u b a
ntshwafatsa	n ts_h w a f a ts_> a
ntshwafatso	n ts_h w a f a ts_> O
ntwa	n t_> w a
ntšha	n tS_h a
ntšhwa	n tS_h w a
ntšhwafale	n tS_h w a f a l E
nwa	n w a
nyaa	J a
nyala	J a l a
nyalana	J a l a n a
nyalanang	J a l a n a N
nyalane	J a l a n E
nyalaneleng	J a l a n E l E N
nyalelano	J a l E l a n O
nyalo	J a l O
nyalwa	J a l w a
nyalwang	J a l w a N
nyati	J a t_> i
nyatsa	J a ts_> a
nyeletse	J E l E ts_> E
nyetseng	J E ts_> E N
nyetswe	J E ts_> w E
nyumokhonosisi	J u m O k_h O n O s i s i
o	O
oa	O a
obama	O b a m a
obama	O b a m E
obamela	O b a m E l a
obamelwa	O b a m E l w a
occupied	O k_h j u p_h a d
october	O k_h t_h O b E r
of	O f
ofe	O f E
office	O f E s
ofiseng	O f i s E N
ofisi	O f i s i
ofising	O f i s i N
okeditsweng	O k_> E d i ts_> w E N
okediwe	O k_> E d i w E
oketsa	O k_> E ts_> a
oketse	O k_> E ts_> E
oketsegang	O k_> E ts_> E x a N
oketsegileng	O k_> E ts_> E x i l E N
oketswa	O k_> E ts_> w a
old	O l d
ole	O l E
olela	O l E l a
ona	O n a
onea	O n E a
onetseng	O n E ts_> E N
ono	O n O
oo	O O
opafaditsweng	O p_> a f a d i ts_> w E N
opafadiwang	O p_> a f a d i w a N
opafatsa	O p_> a f a ts_> a
ope	O p_> E
opelwang	O p_> E l w a N
open	O p_> E n
open	O p_h E n
operation	O p_> E r a t_> i O n
operation	O p_h E r E s E n
opile	O p_> i l E
ora	O r a
orange	O r a N E
orange	O r i n d_0Z
order	O d E r
order	O r d E r
ordered	O d E d
ordered	O r d E r E d
organization	O k_> E n a s E s E n
orkney	O k_h n i
orkney	O r k_> n E j
orthodox	O f E d O k_h s
orthodox	O r t_h O d O
osama	O s a m a
osele	O s E l E
otlhe	O tl_h E
ouma	O u m a
out	a t_h
out	O u t_>
owaii	O w a i i
paakanyo	p_> a k_> a J O
paarl	p_> a r l
paarl	p_h a l
pabalelo	p_> a b a l E l O
pabalesego	p_> a b a l E s E x O
pabalesegong	p_> a b a l E s E x O N
pac	p_h E k_h
padi	p_> a d i
page	p_> a x E
page	p_h E d_0Z
pagolola	p_> a x O l O l a
paka	p_> a k_> a
pakakhutshwe	p_> a k_> a k_h u ts_h w E
pakang	p_> a k_> a N
pakeng	p_> a k_> E N
paki	p_> a k_> i
palama	p_> a l a m a
palamente	p_> a l a m E n t_> E
palamenteng	p_> a l a m E n t_> E N
palelwa	p_> a l E l w a
palo	p_> a l O
palo	p_h a l O
pampiri	p_> a m p_> i r i
pampiring	p_> a m p_> i r i N
papa	p_> a p_> a
papa	p_h E p_h a
papatso	p_> a p_> a ts_> O
papetlana	p_> a p_> E tl_> a n a
parafini	p_> a r a f i n i
parity	p_> a r i t_> j
parity	p_h a r E t_h i
park	p_> a r k_>
park	p_h a k_h
parkland	p_> a r k_> l a n d
parkland	p_h a k_h l E n d
parliament	p_> a r l i a m E n t_>
parliament	p_h a l E m E n t_h
partially	p_> a r t_> i a l l j
partially	p_h a s E l i
parties	p_> a r t_> i E s
parties	p_h a t_h i s
partner	p_> a r t_> n E r
partner	p_h a t_h n E r
party	p_> a r t_> j
party	p_h a t_h i
pasa	p_> a s a
paseng	p_> a s E N
paseporoto	p_> a s E p_> O r O t_> O
password	p_> a s w O r d
password	p_h a s w a d
past	p_> a s t_>
past	p_h a s t_h
pataganya	p_> a t_> a x a J a
pateleditswe	p_> a t_> E l E d i ts_> w E
patelesego	p_> a t_> E l E s E x O
pateletse	p_> a t_> E l E ts_> E
pateletsega	p_> a t_> E l E ts_> E x a
pateletso	p_> a t_> E l E ts_> O
patente	p_> a t_> E n t_> E
patika	p_> a t_> i k_> a
patlisiso	p_> a tl_> i s i s O
patlo	p_> a tl_> O
patlomaikutlo	p_> a tl_> O m a i k_> u tl_> O
paul	p_> a u l
paul	p_h O l
paye	p_> a j E
pedi	p_> E d i
pedro	p_> E d r O
pedro	p_h E d r O
peel	p_> E E l
peel	p_h i l
peelano	p_> E E l a n O
peeletso	p_> E E l E ts_> O
pegelo	p_> E x E l O
pego	p_> E x O
pejana	p_> E d_0Z a n a
pelafalo	p_> E l a f a l O
pele	p_> E l E
pelo	p_> E l O
pelong	p_> E l O N
pelwana	p_> E l w a n a
peomolao	p_> E O m O l a O
pepeneneng	p_> E p_> E n E n E N
persian	p_> E r i a n
persian	p_h a s E n
persons	p_> E r O n s
persons	p_h a s E n s
petelelo	p_> E t_> E l E l O
peterolo	p_> E t_> E r O l O
petse	p_> E ts_> E
pha	p_h a
phaa	p_h a a
phakela	p_h a k_> E l a
phalane	p_h a l a n E
phaloso	p_h a l O s O
phamiti	p_h a m i t_> i
phamokate	p_h a m O k_> a t_> E
phanele	p_h a n E l E
phanyegileng	p_h a J E x i l E N
phaposiborutelo	p_h a p_> O s i b O r u t_> E l O
phaposo	p_h a p_> O s O
pharakano	p_h a r a k_> a n O
pharologano	p_h a r O l O x a n O
pharologanyo	p_h a r O l O x a J O
phasaladitseng	p_h a s a l a d i ts_> E N
phasaladitsweng	p_h a s a l a d i ts_> w E N
phasaladiwa	p_h a s a l a d i w a
phasalatsa	p_h a s a l a ts_> a
phasalatse	p_h a s a l a ts_> E
phasalatso	p_h a s a l a ts_> O
phaseporoto	p_h a s E p_> O r O t_> O
phatleng	p_h a tl_> E N
phatlha	p_h a tl_h a
phatlhoso	p_h a tl_h O s O
phatlhothoto	p_h a tl_h O t_h O t_> O
phato	p_h a t_> O
phatsimisa	p_h a ts_> i m i s a
phatwe	p_h a t_> w E
phediso	p_h E d i s O
phefo	p_h E f O
phekola	p_h E k_> O l a
phekolo	p_h E k_> O l O
phela	p_h E l a
pheletsong	p_h E l E ts_> O N
phemithi	p_h E m i t_h i
phemiti	p_h E m i t_> i
phensene	p_h E n s E n E
phepa	p_h E p_> a
phepafatsa	p_h E p_> a f a ts_> a
phepo	p_h E p_> O
phesente	p_h E s E n t_> E
phetherol	p_h E t_h E r O l
phetisetso	p_h E t_> i s E ts_> O
phetiso	p_h E t_> i s O
phetogo	p_h E t_> O x O
phetolelo	p_h E t_> O l E l O
phetolo	p_h E t_> O l O
phešwana	p_h E S w a n a
phika	p_h i k_> a
phiketa	p_h i k_> E t_> a
philip	f E l E p_h
philip	p_h i l i p_>
phimogeng	p_h i m O x E N
phimola	p_h i m O l a
phimolakeledi	p_h i m O l a k_> E l E d i
phimolang	p_h i m O l a N
phimole	p_h i m O l E
phimolo	p_h i m O l O
phiri	p_h i r i
phirima	p_h i r i m a
phitlhelelo	p_h i tl_h E l E l O
phitlhelelong	p_h i tl_h E l E l O N
phitlho	p_h i tl_h O
phofu	p_h O f u
phoka	p_h O k_> a
phokeng	p_h O k_> E N
phokoletso	p_h O k_> O l E ts_> O
pholese	p_h O l E s E
pholeseng	p_h O l E s E N
pholesi	p_h O l E s i
pholesing	p_h O l E s i N
pholisi	p_h O l i s i
pholising	p_h O l i s i N
pholo	p_h O l O
phologolo	p_h O l O x O l O
phoso	p_h O s O
phothulola	p_h O t_h u l O l a
phousetara	p_h O u s E t_> a r a
phuagantswe	p_h u a x a n ts_> w E
phuduso	p_h u d u s O
phulo	p_h u l O
phuruphutso	p_h u r u p_h u ts_> O
phutha	p_h u t_h a
phuthologe	p_h u t_h O l O x E
physics	f i s i k_h s
pikwe	p_> i k_> w E
pila	p_> i l a
pina	p_> i n a
pinagare	p_> i n a x a r E
pirigana	p_> i r i x a n a
pitsa	p_> i ts_> a
pitsana	p_> i ts_> a n a
pitse	p_> i ts_> E
pitso	p_> i ts_> O
planned	p_h l a n d
planned	p_> l a n n E d
platform	p_h l a t_h f O m
platform	p_> l a t_> f O r m
podi	p_> O d i
poelano	p_> O E l a n O
poeletso	p_> O E l E ts_> O
poeletsogape	p_> O E l E ts_> O x a p_> E
poelo	p_> O E l O
poelong	p_> O E l O N
poelothuto	p_> O E l O t_h u t_> O
pogiso	p_> O x i s O
polante	p_> O l a n t_> E
polaseng	p_> O l a s E N
polatefomo	p_> O l a t_> E f O m O
polelo	p_> O l E l O
polelwana	p_> O l E l w a n a
policy	p_h O l E s i
political	p_h E l E t_h i k_h E l
polokego	p_> O l O k_> E x O
polokelo	p_> O l O k_> E l O
poloko	p_> O l O k_> O
poloto	p_> O l O t_> O
pompelang	p_> O m p_> E l a N
pono	p_> O n O
ponokutlo	p_> O n O k_> u tl_> O
poo	p_> O O
popaganyo	p_> O p_> a x a J O
pope	p_h O p_h
pope	p_> O p_> E
popego	p_> O p_> E x O
popegong	p_> O p_> E x O N
popelo	p_> O p_> E l O
popo	p_> O p_> O
poraebete	p_> O r a E b E t_> E
poraefete	p_> O r a E f E t_> E
poresidente	p_> O r E s i d E n t_> E
poresitente	p_> O r E s i t_> E n t_> E
porofe	p_> O r O f E
porofense	p_> O r O f E n s E
porofenseng	p_> O r O f E n s E N
porofensi	p_> O r O f E n s i
porofensing	p_> O r O f E n s i N
porojeke	p_> O r O d_0Z E k_> E
porotokolo	p_> O r O t_> O k_> O l O
port	p_h O t_h
port	p_> O r t_>
posa	p_> O s a
poso	p_> O s O
posong	p_> O s O N
post	p_h O s t_h
post	p_> O s t_>
potefoliong	p_> O t_> E f O l i O N
potiela	p_> O t_> i E l a
potlakeng	p_> O tl_> a k_> E N
potlana	p_> O tl_> a n a
potso	p_> O ts_> O
power	p_h a E r
power	p_> O w E r
president	p_h r E s E d E n t_h
president	p_> r E s i d E n t_>
presley's	p_h r E s l i s
price	p_h r a s
priest	p_h r i s t_h
priest	p_> r i E s t_>
priests	p_h r i s t_h s
priests	p_> r i E s ts_>
primary	p_h r a m E r i
primary	p_> r i m a r j
prime	p_h r a m
prime	p_> r i m E
printer	p_h r E n t_h E r
printer	p_> r i n t_> E r
privileges	p_h r E f E l i d_0Z E s
privileges	p_> r i i l E x E s
pro	p_h r O
pro	p_> r O
probability	p_h r O b E b E l E t_h i
probability	p_> r O b a b i l i t_> j
product	p_h r O d a k_h t_h
professional	p_h r E f E s E n E l
professional	p_> r O f E s i O n a l
programming	p_h r O k_> r a m i N
programming	p_> r O x r a m m i N
project	p_h r O d_0Z E k_h t_h
property	p_h r O p_h E t_h i
property	p_> r O p_> E r t_> j
protocol	p_h r O t_h E k_h O l
ptsd	p_h i t_h i E s d i
ptsd	p_> ts_> d
public	p_h a b l i k_h
publication	p_h a b l i k_h E s E n
puisano	p_> u i s a n O
puiso	p_> u i s O
pula	p_> u l a
pule	p_h u l
pule	p_> u l E
puo	p_> u O
puong	p_> u O N
pusat	p_h u s a t_h
pusat	p_> u s a t_>
pusetso	p_> u s E ts_> O
puso	p_> u s O
pusong	p_> u s O N
queen	k_h w i n
r	a r
ra	r a
radio	r a d i O
radio	r E d E E
radioloji	r a d i O l O d_0Z i
raelesega	r a E l E S E x a
raese	r a E s E
rafiki	r a f i k_> i
rakana	r a k_> a n a
rakgomotso	r a kx O m O ts_> O
ralala	r a l a l a
ralekwatiti	r a l E k_> w a t_> i t_> i
ramarumo	r a m a r u m O
ramatlotlo	r a m a tl_> O tl_> O
ramatshwao	r a m a ts_h w a O
ramoepa	r a m O E p_> a
ramoepo	r a m O E p_> O
ramoopampa	r a m O O p_> a m p_> a
ramotla	r a m O tl_> a
rangwaneago	r a N w a n E a x O
ranko	r a n k_> O
ranoko	r a n O k_> O
ranola	r a n O l a
ranta	r a n t_> a
rantleru	r a n tl_> E r u
raporoto	r a p_> O r O t_> O
rara	r a r a
rarabolola	r a r a b O l O l a
rarabolotsweng	r a r a b O l O ts_> w E N
rasebintsolo	r a s E b i n ts_> O l O
raseboa	r a s E b O a
rata	r a t_> a
ratang	r a t_> a N
rate	r a t_> E
rate	r E t_h
rategang	r a t_> E x a N
ratoropo	r a t_> O r O p_> O
ratu	r a t_> u
raya	r a j a
rbbon	r i b O n
re	r E
re	r i
reagile	r E a x i l E
rebola	r E b O l a
rebolang	r E b O l a N
rebole	r E b O l E
rebolela	r E b O l E l a
rebolelwa	r E b O l E l w a
rebolwa	r E b O l w a
rebolwang	r E b O l w a N
rebolwe	r E b O l w E
rebotse	r E b O ts_> E
rebotswe	r E b O ts_> w E
rebotsweng	r E b O ts_> w E N
recent	r i s E n t_h
record	r E k_h O d
recreation	r E k_h r i E s E n
red	r E d
reediwang	r E E d i w a N
reetsa	r E E ts_> a
reetsang	r E E ts_> a N
referense	r E f E r E n s E
reform	r E f O r m
reform	r i f O m
refosiwa	r E f O s i w a
region	r E x i O n
region	r i d_0Z E n
registry	r E d_0Z E s t_h r i
registry	r E x i s t_> r j
rejisetara	r E d_0Z i s E t_> a r a
rejisetareng	r E d_0Z i s E t_> a r E N
rejiseteri	r E d_0Z i s E t_> E r i
reka	r E k_> a
rekang	r E k_> a N
reketlang	r E k_> E tl_> a N
rekilweng	r E k_> i l w E N
rekisa	r E k_> i s a
rekisitse	r E k_> i s i ts_> E
rekisiwa	r E k_> i s i w a
rekota	r E k_> O t_> a
rekotileng	r E k_> O t_> i l E N
rekotiwe	r E k_> O t_> i w E
rekoto	r E k_> O t_> O
rekotong	r E k_> O t_> O N
rekwang	r E k_> w a N
relay	r E l a j
relay	r i l E
remediale	r E m E d i a l E
renang	r E n a N
reng	r E N
repaboliki	r E p_> a b O l i k_> i
repaboliking	r E p_> a b O l i k_> i N
rephaboliki	r E p_h a b O l i k_> i
rephaboliking	r E p_h a b O l i k_> i N
representative	r E p_h r i s E n t_h E t_h E f
representative	r E p_> r E s E n t_> a t_> i E
republic	r i p_h a b l i k_h
republican	r i p_h a b l i k_h E n
rerelwa	r E r E l w a
rerilwe	r E r i l w E
rerisana	r E r i s a n a
retelelwa	r E t_> E l E l w a
retelelwe	r E t_> E l E l w E
reye	r E j E
reyeng	r E j E N
rg	a r d_0Z i
riana	r i a n a
richard	r i tS_h E d
rights	r a t_h s
rights	r i x h ts_>
rika	r i k_> a
rileng	r i l E N
ripitla	r i p_> i tl_> a
ripitlilweng	r i p_> i tl_> i l w E N
ritela	r i t_> E l a
ritibala	r i t_> i b a l a
road	r O a d
road	r O d
robaditswe	r O b a d i ts_> w E
robala	r O b a l a
robalela	r O b a l E l a
robedi	r O b E d i
robegetseng	r O b E x E ts_> E N
robegileng	r O b E x i l E N
robert	r O b a t_h
robert	r O b E r t_>
rock	r O k_h
roman	r O m a n
roman	r O m E n
romela	r O m E l a
romelang	r O m E l a N
romele	r O m E l E
romelwa	r O m E l w a
romelwe	r O m E l w E
romelweng	r O m E l w E N
rometse	r O m E ts_> E
romile	r O m i l E
ron	r O n
rona	r O n a
rorang	r O r a N
rosta	r O s t_> a
rosta	r O s t_h E
rotlhe	r O tl_h E
rotloediwe	r O tl_> O E d i w E
rotloetsang	r O tl_> O E ts_> a N
rotloetse	r O tl_> O E ts_> E
roto	r O t_> O
rotseng	r O ts_> E N
royal	r O E l
royal	r O j a l
rra	r r a
rraabo	r r a b O
rraago	r r a x O
rraagwe	r r a x w E
rraetsho	r r a E ts_h O
rralori	r r a l O r i
rranoko	r r a n O k_> O
rre	r r E
rremogolo	r r E m O x O l O
rro	r r O
rsa	r a
rua	r u a
ruang	r u a N
rudisa	r u d i s a
rulagane	r u l a x a n E
rulaganeng	r u l a x a n E N
rulaganngwa	r u l a x a n N w a
rulaganya	r u l a x a J a
rulaganye	r u l a x a J E
rulaganyetsang	r u l a x a J E ts_> a N
rumotsweng	r u m O ts_> w E N
run	r a n
run	r u n
runtseng	r u n ts_> E N
ruri	r u r i
rurifatsa	r u r i f a ts_> a
russian	r a s E n
russian	r u s i a n
rustenburg	r a s t_h E n b a k_>
rustenburg	r u s t_> E n b u r
ruta	r u t_> a
rutwa	r u t_> w a
rwala	r w a l a
rwale	r w a l E
rwalela	r w a l E l a
rwele	r w E l E
rweleng	r w E l E N
s	E s
sa	E s E
sa	s a
sabc	E s E b i s i
sabc	s a b k_h
sabs	E s E b i E s
sacnap	s a k_h n E p_h
sacnasp	s a k_h n E s p_h
sacramento	s a k_h r E m E n t_h O
saekele	s a E k_> E l E
saena	s a E n a
saenang	s a E n a N
saene	s a E n E
saenilwe	s a E n i l w E
saenilweng	s a E n i l w E N
saenneng	s a E n n E N
saense	s a E n s E
saenwa	s a E n w a
saenweng	s a E n w E N
saete	s a E t_> E
saeteng	s a E t_> E N
sag	s a k_>
sag	s a x
saint	s a i n t_>
saint	s E n t_h
saints	s a i n ts_>
saints	s E n t_h s
sajene	s a d_0Z E n E
sala	s a l a
salang	s a l a N
salatseng	s a l a ts_> E N
sale	s a l E
sale	s E l
saletse	s a l E ts_> E
saletseng	s a l E ts_> E N
salga	s a l a
salt	s a l t_>
salt	s O l t_h
salwe	s a l w E
samagana	s a m a x a n a
samaganwa	s a m a x a n w a
sampo	s a m p_> O
sampole	s a m p_> O l E
san	s a n
sandf	E s E E n d i E f
sandf	s a n d f
sankatane	s a n k_> a t_> a n E
sanskrit	s a n s k_h r E t_h
sanskrit	s a n s k_> r i t_>
santlha	s a n tl_h a
santse	s a n ts_> E
sap	s a p_>
sap	s a p_h
sapphire	s a p_h f i E r
sapphire	s a p_> p_h i r E
saps	s a p_>
saps	s a p_h s
saqa	s a k_h E
sars	s a r
sars	s a r s
sash	s a s
sasolburg	s a s E l b a k_>
sasolburg	s a s O l b u r
sati	s a t_> i
saudi	s a d i
saudi	s a u d i
school	s k_h u l
science	s a E n s
scott	s k_h O t_h
scottish	s k_h O t_h i s
scrolls	s k_h r O l s
se	s E
sea	s E a
sea	s i
seabe	s E a b E
seaforika	s E a f O r i k_> a
seaforikanse	s E a f O r i k_> a n s E
seako	s E a k_> O
seal	s E a l
seal	s i l
seapesa	s E a p_> E s a
search	s a tS_h
seatla	s E a tl_> a
seatleng	s E a tl_> E N
seaway	s E a w a j
seaway	s i w E
sebaka	s E b a k_> a
sebakanyana	s E b a k_> a J a n a
sebakeng	s E b a k_> E N
sebe	s E b E
sebebofatsi	s E b E b O f a ts_> i
sebele	s E b E l E
sebelel	s E b E l E l
sebetsa	s E b E ts_> a
sebg	s E b i d_0Z i
seboba	s E b O b a
sebokeng	s E b O k_> E N
sebopego	s E b O p_> E x O
sebui	s E b u i
second	s E k_h E n d
secretary	s E k_h r E t_h r i
security	s E k_h j O r E t_h i
sediba	s E d i b a
sedika	s E d i k_> a
sediko	s E d i k_> O
sedimonthole	s E d i m O n t_h O l E
sedimosa	s E d i m O s a
sedimosiwa	s E d i m O s i w a
sedirela	s E d i r E l a
sedirisiwa	s E d i r i s i w a
sediriswa	s E d i r i s w a
sedumedi	s E d u m E d i
seduti	s E d u t_> i
seedimonthole	s E E d i m O n t_h O l E
seemanosi	s E E m a n O s i
seemo	s E E m O
seeng	s E E N
seesemane	s E E s E m a n E
seesimane	s E E s i m a n E
seetebosego	s E E t_> E b O s E x O
seetebosigo	s E E t_> E b O s i x O
sefako	s E f a k_> O
sefalana	s E f a l a n a
sefane	s E f a n E
sefapaano	s E f a p_> a n O
sefaphi	s E f a p_h i
sefe	s E f E
sefitlholo	s E f i tl_h O l O
sefolletse	s E f O l l E ts_> E
sega	s E x a
segakolodi	s E x a k_> O l O d i
segalo	s E x a l O
segasi	s E x a s i
segogelathusong	s E x O x E l a t_h u s O N
segole	s E x O l E
segolo	s E x O l O
segolosetonna	s E x O l O s E t_> O n n a
segoro	s E x O r O
segwagwa	s E x w a x w a
segwete	s E x w E t_> E
seinong	s E i n O N
sejalo	s E d_0Z a l O
sejana	s E d_0Z a n a
sejanaga	s E d_0Z a n a x a
seka	s E k_> a
sekae	s E k_> a E
sekai	s E k_> a i
sekakaseka	s E k_> a k_> a s E k_> a
sekano	s E k_> a n O
sekao	s E k_> a O
sekaseka	s E k_> a s E k_> a
sekasekang	s E k_> a s E k_> a N
sekasekiwa	s E k_> a s E k_> i w a
sekasekwa	s E k_> a s E k_> w a
sekasekwe	s E k_> a s E k_> w E
seke	s E k_> E
sekema	s E k_> E m a
sekeme	s E k_> E m E
sekemeng	s E k_> E m E N
sekeng	s E k_> E N
sekgala	s E kx a l a
sekgaleng	s E kx a l E N
sekgoa	s E kx O a
sekgono	s E kx O n O
sekgoreletsi	s E kx O r E l E ts_> i
sekgwa	s E kx w a
sekgwamana	s E kx w a m a n a
sekhutlhwana	s E k_h u tl_h w a n a
sekisa	s E k_> i s a
sekolo	s E k_> O l O
sekolong	s E k_> O l O N
sekoloto	s E k_> O l O t_> O
sekorolo	s E k_> O r O l O
sekwasekwa	s E k_> w a s E k_> w a
sele	s E l E
selebi	s E l E b i
selegae	s E l E x a E
selekano	s E l E k_> a n O
selekanyo	s E l E k_> a J O
selelo	s E l E l O
selinah	s E l i n a h
selinah	s l E n E
selipi	s E l i p_> i
seliping	s E l i p_> i N
sell	s E l
sell	s E l l
sello	s E l l O
selo	s E l O
selong	s E l O N
selula	s E l u l a
semane	s E m a n E
semathana	s E m a t_h a n a
semela	s E m E l a
semenogi	s E m E n O x i
semmuso	s E m m u s O
semolao	s E m O l a O
semonogi	s E m O n O x i
semorafeng	s E m O r a f E N
semoseleme	s E m O s E l E m E
sena	s E n a
senanapo	s E n a n a p_> O
senang	s E n a N
senate	s E n a t_> E
senate	s E n E t_h
senekal	s E n E k_> a l
seng	s E N
sengwe	s E N w E
sengwenyana	s E N w E J a n a
senkepeng	s E n k_> E p_> E N
senna	s E n E
senna	s E n n a
senngwa	s E n N w a
seno	s E n O
senoga	s E n O x a
senola	s E n O l a
senotlele	s E n O tl_> E l E
sentech	s E n t_h E k_h
sentle	s E n tl_> E
sentlentle	s E n tl_> E n tl_> E
sentsweng	s E n ts_> w E N
senya	s E J a
senyaka	s E J a k_> a
senyega	s E J E x a
senyege	s E J E x E
senyegileng	s E J E x i l E N
senyesemane	s E J E s E m a n E
senyesimane	s E J E s i m a n E
seo	s E O
sepalaka	s E p_> a l a k_> a
sepe	s E p_> E
sepetlele	s E p_> E tl_> E l E
sephara	s E p_h a r a
sephiri	s E p_h i r i
sephuthelo	s E p_h u t_h E l O
sephuthelong	s E p_h u t_h E l O N
sepodisi	s E p_> O d i s i
sepolotiki	s E p_> O l O t_> i k_> i
seporo	s E p_> O r O
seporofe	s E p_> O r O f E
serame	s E r a m E
seraro	s E r a r O
sere	s E r
sere	s E r E
series	s E r i E s
series	s E r i s
serisi	s E r i s i
serisikgolo	s E r i s i kx O l O
serisikgolong	s E r i s i kx O l O N
serising	s E r i s i N
seriti	s E r i t_> i
seritibatsi	s E r i t_> i b a ts_> i
serori	s E r O r i
seroring	s E r O r i N
serutwa	s E r u t_> w a
service	s a f E s
sese	s E s E
sesenyi	s E s E J i
sesiraphefo	s E s i r a p_h E f O
sesole	s E s O l E
sesolo	s E s O l O
sesotho	s E s O t_h O
sesotho	s s E t_h O
sesupo	s E s u p_> O
seswa	s E s w a
seswati	s E s w a t_> i
set	s E t_>
set	s E t_h
setaele	s E t_> a E l E
setampa	s E t_> a m p_> a
setatamente	s E t_> a t_> a m E n t_> E
setatshe	s E t_> a ts_h E
sete	s E t_> E
setebela	s E t_> E b E l a
setebele	s E t_> E b E l E
setefekeiti	s E t_> E f E k_> E i t_> i
setefikeite	s E t_> E f i k_> E i t_> E
setefikeiti	s E t_> E f i k_> E i t_> i
setefikeiting	s E t_> E f i k_> E i t_> i N
setegeniki	s E t_> E x E n i k_> i
seteitemente	s E t_> E i t_> E m E n t_> E
seteitementeng	s E t_> E i t_> E m E n t_> E N
seteišene	s E t_> E i S E n E
seteišeneng	s E t_> E i S E n E N
setella	s E t_> E l l a
seterebo	s E t_> E r E b O
seth	s E t_h
seth	s E t_> i E tS_h
setha	s E t_h a
sethaba	s E t_h a b a
sethalo	s E t_h a l O
setheo	s E t_h E O
setheong	s E t_h E O N
setho	s E t_h O
sethombe	s E t_h O m b E
sethosa	s E t_h O s a
sethunya	s E t_h u J a
sethwe	s E t_h w E
seti	s E t_> i
setifikeite	s E t_> i f i k_> E i t_> E
setifikeiti	s E t_> i f i k_> E i t_> i
setifikeiting	s E t_> i f i k_> E i t_> i N
setileng	s E t_> i l E N
setilong	s E t_> i l O N
setimamolelo	s E t_> i m a m O l E l O
setlabošane	s E tl_> a b O S a n E
setlaleletsi	s E tl_> a l E l E ts_> i
setlami	s E tl_> a m i
setlamo	s E tl_> a m O
setlamong	s E tl_> a m O N
setlankana	s E tl_> a n k_> a n a
setlankaneng	s E tl_> a n k_> a n E N
setlankna	s E tl_> a n k_> n a
setlha	s E tl_h a
setlhabelo	s E tl_h a b E l O
setlhabi	s E tl_h a b i
setlhangwa	s E tl_h a N w a
setlhatswa	s E tl_h a ts_> w a
setlhogo	s E tl_h O x O
setlhogwana	s E tl_h O x w a n a
setlhokwa	s E tl_h O k_> w a
setlhong	s E tl_h O N
setlhopha	s E tl_h O p_h a
setlogolo	s E tl_> O x O l O
setlogolwana	s E tl_> O x O l w a n a
setlwaedi	s E tl_> w a E d i
setonti	s E t_> O n t_> i
setopo	s E t_> O p_> O
setoto	s E t_> O t_> O
setphaba	s E t_> p_h a b a
setse	s E ts_> E
setseng	s E ts_> E N
setsha	s E ts_h a
setshaba	s E ts_h a b a
setshegetsa	s E ts_h E x E ts_> a
setsheng	s E ts_h E N
setshwansho	s E ts_h w a n s O
setshwantsho	s E ts_h w a n ts_h O
setshwantshogo	s E ts_h w a n ts_h O x O
setshwantshotshupo	s E ts_h w a n ts_h O ts_h u p_> O
setso	s E ts_> O
setsonga	s E ts_> O N a
setswadi	s E ts_> w a d i
setswana	s E t_h s w E n E
setswana	s E ts_> w a n a
setulong	s E t_> u l O N
setšhaba	s E tS_h a b a
seven	s E E n
seven	s E f E n
sewelo	s E w E l O
seyantlo	s E j a n tl_> O
sešwa	s E S w a
sešwengšeng	s E S w E N S E N
sheridan	s E r E d E n
sheridan	s E r i d a n
sherman	s a m E n
sherman	s E r m a n
shitse	s i ts_> E
short	s O r t_>
short	s O t_h
siamang	s i a m a N
siame	s i a m E
siamela	s i a m E l a
siamele	s i a m E l E
siameng	s i a m E N
siametseng	s i a m E ts_> E N
siamisa	s i a m i s a
siamisiwa	s i a m i s i w a
siana	s i a n a
sianela	s i a n E l a
sign	s a n
sign	s i x n
silikhosisi	s i l i k_h O s i s i
simane	s i m a n E
simolola	s i m O l O l a
simololang	s i m O l O l a N
simolole	s i m O l O l E
simololwang	s i m O l O l w a N
singapore	s i N a p_> O r E
singapore	s i N k_> a p_h O r
singers	s i N E r
singers	s i N E s
sir	s a r
sir	s i r
sireletsa	s i r E l E ts_> a
sireletsang	s i r E l E ts_> a N
sireletswa	s i r E l E ts_> w a
sirolola	s i r O l O l a
site	s a t_h
site	s i t_> E
sk	E s k_h E
sk	s k_>
slavonic	s l E f O n i k_h
smedp	s m E d i p_> i
soccer	s O k_h E r
socialist	s O s E l E s t_h
soft	s O f t_>
soft	s O f t_h
software	s O f t_h w E r
software	s O f t_> w a r E
sokuto	s O k_> u t_> O
sokutu	s O k_> u t_> u
soldiers	s O l d_0Z E s
soldiers	s O l d i E r
solofela	s O l O f E l a
solofelwang	s O l O f E l w a N
solofetsweng	s O l O f E ts_> w E N
somarelegile	s O m a r E l E x i l E
sometlhano	s O m E tl_h a n O
sona	s O n a
sotla	s O tl_> a
sotlaka	s O tl_> a k_> a
sotlhe	s O tl_h E
source	s O s
sources	s O s E s
south	s a f
south	s O u t_h
southeast	s a f i s t_h
southeast	s O u t_h E a s t_>
southwestern	s a f w E s t_h E n
southwestern	s O u t_h w E s t_> E r n
soviet	s O f E t_h
soviet	s O i E t_>
soweto	s O w E t_> O
soweto	s u w E t_h O
sox	s O
sox	s O k_h s
space	s p_h E s
sport	s p_h O t_h
sport	s p_> O r t_>
sports	s p_h O t_h s
sports	s p_> O r ts_>
springbok	s p_h r i N b O k_h
springbok	s p_> r i N b O k_>
sssoomamang	s O O m a m a N
state	s t_> a t_> E
state	s t_h E t_h
states	s t_> a t_> E s
states	s t_h E t_h s
statistic	s t_h E t_h i s t_h i k_h
statistik	s t_> a t_> i s t_> i k_>
statistik	s t_h E t_h E s t_h i k_h
stke	E s t_h i k_h E i
stock	s t_h O k_h
story	s t_h O r i
story	s t_> O r j
strategic	s t_h r E t_h i d_0Z i k_h
street	s t_h r i t_h
street	s t_> r E E t_>
students	s t_h j u d E n t_h s
students	s t_> u d E n ts_>
success	s E k_h s E s
sukiri	s u k_> i r i
sula	s u l a
sun	s a n
sun	s u n
supa	s u p_> a
supang	s u p_> a N
supe	s u p_> E
supileng	s u p_> i l E N
supilwe	s u p_> i l w E
supilweng	s u p_> i l w E N
supiwa	s u p_> i w a
supiwang	s u p_> i w a N
supply	s E p_h l a
supply	s u p_> p_> l j
supreme	s u p_h r i m
supreme	s u p_> r E m E
sutisediwa	s u t_> i s E d i w a
sutlhile	s u tl_h i l E
suu	E s j u j u
suu	s u u
swabileng	s w a b i l E N
sweditsweng	s w E d i ts_> w E N
swetsa	s w E ts_> a
swetse	s w E ts_> E
swetseng	s w E ts_> E N
t	t_h i
taelo	t_> a E l O
tafoleng	t_> a f O l E N
tagafara	t_> a x a f a r a
takes	t_> a k_> E s
takes	t_h E k_h s
takileng	t_> a k_> i l E N
tala	t_> a l a
taletso	t_> a l E ts_> O
tami	t_> a m i
tampa	t_> a m p_> a
tampa	t_h a m p_h E
tanzania	t_h a n s E n E
tao	t_> a O
tao	t_h a
taolelo	t_> a O l E l O
taolo	t_> a O l O
taolong	t_> a O l O N
task	t_> a s k_>
task	t_h a s k_h
tatelano	t_> a t_> E l a n O
tatlhegelo	t_> a tl_h E x E l O
tau	t_> a u
tb	t_h i b i
tbcsa	t_h b k_h s E
tbcsa	t_h i b i s i E s E
tdc	t_h d k_h
tdc	t_h i d i s i
tdotlhe	t_> d O tl_h E
te	t_> E
te	t_h i i
team	t_> E a m
team	t_h i m
teams	t_> E a m
teams	t_h i m s
tebang	t_> E b a N
tebego	t_> E b E x O
tebelelo	t_> E b E l E l O
tebelo	t_> E b E l O
tebo	t_> E b O
technikon	t_h E k_h n a k_h E n
technology	t_h E k_h n O l E d_0Z i
teddy	t_> E d d j
teddy	t_h E d i
teemaneng	t_> E E m a n E N
tefiso	t_> E f i s O
tefo	t_> E f O
tekano	t_> E k_> a n O
tekanyetso	t_> E k_> a J E ts_> O
tekanyetsokabo	t_> E k_> a J E ts_> O k_> a b O
tekanyetsong	t_> E k_> a J E ts_> O N
tekanyo	t_> E k_> a J O
tekatekano	t_> E k_> a t_> E k_> a n O
tekete	t_> E k_> E t_> E
tekisontle	t_> E k_> i s O n tl_> E
teko	t_> E k_> O
tekolo	t_> E k_> O l O
tela	t_> E l a
telekeramo	t_> E l E k_> E r a m O
teleko	t_> l E k_> O
telele	t_> E l E l E
television	t_> E l E i s i O n
television	t_h E l i f i d_0Z E n
temana	t_> E m a n a
temaneng	t_> E m a n E N
tematheto	t_> E m a t_h E t_> O
temeng	t_> E m E N
temo	t_> E m O
temokerasi	t_> E m O k_> E r a s i
temokerasing	t_> E m O k_> E r a s i N
temothuo	t_> E m O t_h u O
temothuokgwebo	t_> E m O t_h u O kx w E b O
tempiwa	t_> E m p_> i w a
teng	t_> E N
tennyana	t_> E n J a n a
teofo	t_> E O f O
terama	t_> E r a m a
terasete	t_> E r a s E t_> E
terena	t_> E r E n a
teropo	t_> E r O p_> O
terry	t_> E r r j
terry	t_h E r i
terry's	t_h E r i s
tesetamente	t_> E s E t_> a m E n t_> E
tesetamenteng	t_> E s E t_> a m E n t_> E N
test	t_> E s t_>
test	t_h E s t_h
teta	t_> E t_> a
tetla	t_> E tl_> a
tetlokgatiso	t_> E tl_> O kx a t_> i s O
tewa	t_> E w a
teye	t_> E j E
thabantsho	t_h a b a n ts_h O
thabong	t_h a b O N
thadisa	t_h a d i s a
thadiso	t_h a d i s O
thadiwa	t_h a d i w a
thaetlele	t_h a E tl_> E l E
thaetswe	t_h a E ts_> w E
thaka	t_h a k_> a
thala	t_h a l a
thalele	t_h a l E l E
thalelo	t_h a l E l O
thaletsweng	t_h a l E ts_> w E N
thando	t_h a n d O
thanolo	t_h a n O l O
thapa	t_h a p_> a
thapilwe	t_h a p_> i l w E
thapilweng	t_h a p_> i l w E N
thapiwa	t_h a p_> i w a
thapo	t_h a p_> O
tharabololo	t_h a r a b O l O l O
thari	t_h a r i
tharo	t_h a r O
thata	t_h a t_> a
thataro	t_h a t_> a r O
thatathata	t_h a t_> a t_h a t_> a
thaya	t_h a j a
the	d E
the	t_h E
theatre	f E t_h E r
theatre	t_h E a t_> r E
thebe	t_h E b E
thebolelo	t_h E b O l E l O
thebolo	t_h E b O l O
theilwe	t_h E i l w E
thekenoloji	t_h E k_> E n O l O d_0Z i
thekgwaneng	t_h E kx w a n E N
thekiso	t_h E k_> i s O
thekisontle	t_h E k_> i s O n tl_> E
thekontle	t_h E k_> O n tl_> E
thelebi	t_h E l E b i
thelebisene	t_h E l E b i s E n E
thelebišene	t_h E l E b i S E n E
thelelo	t_h E l E l O
thembi	t_h E m b i
theo	f E E
theo	t_h E O
therasete	t_h E r a s E t_> E
thesis	f i s E s
thesis	t_h E s i s
thetelelo	t_h E t_> E l E l O
thetelelobokgoni	t_h E t_> E l E l O b O kx O n i
thiba	t_h i b a
thibela	t_h i b E l a
thibelang	t_h i b E l a N
thibelo	t_h i b E l O
thibelong	t_h i b E l O N
thibelwe	t_h i b E l w E
thikga	t_h i kx a
thipa	t_h i p_> a
thišu	t_h i S u
thoba	t_h O b a
thobane	t_h O b a n E
thoko	t_h O k_> O
thokwana	t_h O k_> w a n a
thomelo	t_h O m E l O
thomelontle	t_h O m E l O n tl_> E
thomeloteng	t_h O m E l O t_> E N
thotamadi	t_h O t_> a m a d i
thoto	t_h O t_> O
thube	t_h u b E
thulaganyo	t_h u l a x a J O
thulaganyong	t_h u l a x a J O N
thumolano	t_h u m O l a n O
thusa	t_h u s a
thusana	t_h u s a n a
thusang	t_h u s a N
thuse	t_h u s E
thusegileng	t_h u s E x i l E N
thusiwa	t_h u s i w a
thusiwe	t_h u s i w E
thuso	t_h u s O
thutafatshe	t_h u t_> a f a ts_h E
thutapuo	t_h u t_> a p_> u O
thuthusa	t_h u t_h u s a
thuto	t_h u t_> O
thutokatiso	t_h u t_> O k_> a t_> i s O
thutong	t_h u t_> O N
tibola	t_> i b O l a
tidimalo	t_> i d i m a l O
tiego	t_> i E x O
tiileng	t_> i i l E N
tiisa	t_> i i s a
tikologo	t_> i k_> O l O x O
tikologong	t_> i k_> O l O x O N
tikwatikweng	t_> i k_> w a t_> i k_> w E N
tila	t_> i l a
tima	t_> i m a
times	t_h a m s
times	t_> i m E s
timetse	t_> i m E ts_> E
timetseng	t_> i m E ts_> E N
timilweng	t_> i m i l w E N
tiragalo	t_> i r a x a l O
tiragatso	t_> i r a x a ts_> O
tiragatsong	t_> i r a x a ts_> O N
tiragatsoya	t_> i r a x a ts_> O j a
tirego	t_> i r E x O
tirelo	t_> i r E l O
tirelong	t_> i r E l O N
tirio	t_> i r i O
tirisano	t_> i r i s a n O
tirisanommogo	t_> i r i s a n O m m O x O
tiriso	t_> i r i s O
tirisobotlhaswa	t_> i r i s O b O tl_h a s w a
tirisodikgoka	t_> i r i s O d i kx O k_> a
tirisong	t_> i r i s O N
tirisopuo	t_> i r i s O p_> u O
tiro	t_h a r O
tiro	t_> i r O
tirogae	t_> i r O x a E
tirong	t_> i r O N
title	t_h a t_h E l
title	t_> i tl_> E
tla	tl_> a
tlaa	tl_> a
tladi	tl_> a d i
tladitse	tl_> a d i ts_> E
tladitsweng	tl_> a d i ts_> w E N
tladiwa	tl_> a d i w a
tladiwang	tl_> a d i w a N
tlala	tl_> a l a
tlaleletsa	tl_> a l E l E ts_> a
tlaleletso	tl_> a l E l E ts_> O
tlaleletsong	tl_> a l E l E ts_> O N
tlalelong	tl_> a l E l O N
tlamela	tl_> a m E l a
tlamelang	tl_> a m E l a N
tlamele	tl_> a m E l E
tlamelo	tl_> a m E l O
tlamelwa	tl_> a m E l w a
tlametse	tl_> a m E ts_> E
tlametswe	tl_> a m E ts_> w E
tlametsweng	tl_> a m E ts_> w E N
tlamilwe	tl_> a m i l w E
tlamiwa	tl_> a m i w a
tlamo	tl_> a m O
tlang	tl_> a N
tlase	tl_> a s E
tlatsa	tl_> a ts_> a
tlatse	tl_> a ts_> E
tlatsisa	tl_> a ts_> i s a
tlatsiwa	tl_> a ts_> i w a
tlatswa	tl_> a ts_> w a
tlaya	tl_> a j a
tle	tl_> E
tlelaemete	tl_> E l a E m E t_> E
tleleniki	tl_> E l E n i k_> i
tlelereke	tl_> E l E r E k_> E
tletse	tl_> E ts_> E
tletseng	tl_> E ts_> E N
tlhaba	tl_h a b a
tlhabane	tl_h a b a n E
tlhabano	tl_h a b a n O
tlhabe	tl_h a b E
tlhabelwa	tl_h a b E l w a
tlhabolola	tl_h a b O l O l a
tlhabololo	tl_h a b O l O l O
tlhabololosewa	tl_h a b O l O l O s E w a
tlhabolotsweng	tl_h a b O l O ts_> w E N
tlhaela	tl_h a E l a
tlhaeletsana	tl_h a E l E ts_> a n a
tlhaeletsano	tl_h a E l E ts_> a n O
tlhaelo	tl_h a E l O
tlhafunwang	tl_h a f u n w a N
tlhaga	tl_h a x a
tlhagafaditswe	tl_h a x a f a d i ts_> w E
tlhagang	tl_h a x a N
tlhagelela	tl_h a x E l E l a
tlhagelelang	tl_h a x E l E l a N
tlhagelelo	tl_h a x E l E l O
tlhagisa	tl_h a x i s a
tlhagisang	tl_h a x i s a N
tlhagise	tl_h a x i s E
tlhagisetsa	tl_h a x i s E ts_> a
tlhagisitsweng	tl_h a x i s i ts_> w E N
tlhagisiwa	tl_h a x i s i w a
tlhagisiwe	tl_h a x i s i w E
tlhagiso	tl_h a x i s O
tlhago	tl_h a x O
tlhaka	tl_h a k_> a
tlhakaneng	tl_h a k_> a n E N
tlhakanetse	tl_h a k_> a n E ts_> E
tlhakatlhakano	tl_h a k_> a tl_h a k_> a n O
tlhakole	tl_h a k_> O l E
tlhakong	tl_h a k_> O N
tlhalane	tl_h a l a n E
tlhaloganngwe	tl_h a l O x a n N w E
tlhalogantse	tl_h a l O x a n ts_> E
tlhaloganya	tl_h a l O x a J a
tlhaloganye	tl_h a l O x a J E
tlhaloganyegang	tl_h a l O x a J E x a N
tlhaloganyo	tl_h a l O x a J O
tlhaloganyong	tl_h a l O x a J O N
tlhalosa	tl_h a l O s a
tlhalosang	tl_h a l O s a N
tlhalose	tl_h a l O s E
tlhaloseditswe	tl_h a l O s E d i ts_> w E
tlhalosetsa	tl_h a l O s E ts_> a
tlhalosetse	tl_h a l O s E ts_> E
tlhalositsweng	tl_h a l O s i ts_> w E N
tlhalosiwa	tl_h a l O s i w a
tlhalosiwang	tl_h a l O s i w a N
tlhaloso	tl_h a l O s O
tlhaloswang	tl_h a l O s w a N
tlhama	tl_h a m a
tlhamalalo	tl_h a m a l a l O
tlhamaletseng	tl_h a m a l E ts_> E N
tlhamiwa	tl_h a m i w a
tlhamiwe	tl_h a m i w E
tlhamo	tl_h a m O
tlhang	tl_h a N
tlhano	tl_h a n O
tlhanogetse	tl_h a n O x E ts_> E
tlhaolele	tl_h a O l E l E
tlhaolosetso	tl_h a O l O s E ts_> O
tlhaotsweng	tl_h a O ts_> w E N
tlhapa	tl_h a p_> a
tlhapi	tl_h a p_> i
tlhapileng	tl_h a p_> i l E N
tlhasenyana	tl_h a s E J a n a
tlhasetswe	tl_h a s E ts_> w E
tlhatlhamano	tl_h a tl_h a m a n O
tlhatlhamanong	tl_h a tl_h a m a n O N
tlhatlhamolola	tl_h a tl_h a m O l O l a
tlhatlhamololwa	tl_h a tl_h a m O l O l w a
tlhatlhelelo	tl_h a tl_h E l E l O
tlhatlhelwa	tl_h a tl_h E l w a
tlhatlhoba	tl_h a tl_h O b a
tlhatlhobe	tl_h a tl_h O b E
tlhatlhobiwa	tl_h a tl_h O b i w a
tlhatlhobo	tl_h a tl_h O b O
tlhatlhobong	tl_h a tl_h O b O N
tlhatlhobotsweledi	tl_h a tl_h O b O ts_> w E l E d i
tlhatsilang	tl_h a ts_> i l a N
tlhatswe	tl_h a ts_> w E
tlhe	tl_h E
tlhobogile	tl_h O b O x i l E
tlhodilweng	tl_h O d i l w E N
tlhogo	tl_h O x O
tlhoka	tl_h O k_> a
tlhokafala	tl_h O k_> a f a l a
tlhokafalatswe	tl_h O k_> a f a l a ts_> w E
tlhokafetse	tl_h O k_> a f E ts_> E
tlhokafetseng	tl_h O k_> a f E ts_> E N
tlhokagala	tl_h O k_> a x a l a
tlhokaina	tl_h O k_> a i n a
tlhokang	tl_h O k_> a N
tlhoke	tl_h O k_> E
tlhokega	tl_h O k_> E x a
tlhokegang	tl_h O k_> E x a N
tlhokege	tl_h O k_> E x E
tlhokegeng	tl_h O k_> E x E N
tlhokego	tl_h O k_> E x O
tlhokeng	tl_h O k_> E N
tlhokile	tl_h O k_> i l E
tlhokisa	tl_h O k_> i s a
tlhokiwang	tl_h O k_> i w a N
tlhoko	tl_h O k_> O
tlhokofalela	tl_h O k_> O f a l E l a
tlhokomela	tl_h O k_> O m E l a
tlhokomele	tl_h O k_> O m E l E
tlhokomelo	tl_h O k_> O m E l O
tlhokomelong	tl_h O k_> O m E l O N
tlhokomelwa	tl_h O k_> O m E l w a
tlhokometse	tl_h O k_> O m E ts_> E
tlhokometseng	tl_h O k_> O m E ts_> E N
tlhokometswe	tl_h O k_> O m E ts_> w E
tlhokometsweng	tl_h O k_> O m E ts_> w E N
tlhokomologo	tl_h O k_> O m O l O x O
tlhokwang	tl_h O k_> w a N
tlhola	tl_h O l a
tlholang	tl_h O l a N
tlhole	tl_h O l E
tlholego	tl_h O l E x O
tlholwa	tl_h O l w a
tlhoma	tl_h O m a
tlhomamisa	tl_h O m a m i s a
tlhomamisang	tl_h O m a m i s a N
tlhomamisitswe	tl_h O m a m i s i ts_> w E
tlhomamisitsweng	tl_h O m a m i s i ts_> w E N
tlhomamisiwa	tl_h O m a m i s i w a
tlhomamiso	tl_h O m a m i s O
tlhomang	tl_h O m a N
tlhomile	tl_h O m i l E
tlhomilweng	tl_h O m i l w E N
tlhomiwa	tl_h O m i w a
tlhomo	tl_h O m O
tlhoname	tl_h O n a m E
tlhopha	tl_h O p_h a
tlhophe	tl_h O p_h E
tlhophile	tl_h O p_h i l E
tlhophileng	tl_h O p_h i l E N
tlhophilweng	tl_h O p_h i l w E N
tlhophiwa	tl_h O p_h i w a
tlhotlha	tl_h O tl_h a
tlhotlheletsa	tl_h O tl_h E l E ts_> a
tlhotlheletso	tl_h O tl_h E l E ts_> O
tlhotlhomisa	tl_h O tl_h O m i s a
tlhotlhomisiwang	tl_h O tl_h O m i s i w a N
tlhotlhomiso	tl_h O tl_h O m i s O
tlhotlhwa	tl_h O tl_h w a
tlhotswe	tl_h O ts_> w E
tlile	tl_> i l E
tlileng	tl_> i l E N
tliliniking	tl_> i l i n i k_> i N
tlisa	tl_> i s a
tlisang	tl_> i s a N
tliseditse	tl_> i s E d i ts_> E
tlisitseng	tl_> i s i ts_> E N
tliswa	tl_> i s w a
tloga	tl_> O x a
tlogela	tl_> O x E l a
tlogelo	tl_> O x E l O
tlogelwa	tl_> O x E l w a
tlogelwang	tl_> O x E l w a N
tlogelwe	tl_> O x E l w E
tlogetse	tl_> O x E ts_> E
tlogetswe	tl_> O x E ts_> w E
tlogetsweng	tl_> O x E ts_> w E N
tlokwe	tl_> O k_> w E
tlolelang	tl_> O l E l a N
tlolo	tl_> O l O
tlolomolao	tl_> O l O m O l a O
tlolomolato	tl_> O l O m O l a t_> O
tlolwa	tl_> O l w a
tlosa	tl_> O s a
tlose	tl_> O s E
tlositswe	tl_> O s i ts_> w E
tlositsweng	tl_> O s i ts_> w E N
tlosiwa	tl_> O s i w a
tloso	tl_> O s O
tlotla	tl_> O tl_> a
tlotlegang	tl_> O tl_> E x a N
tlotlo	tl_> O tl_> O
tlotlontswe	tl_> O tl_> O n ts_> w E
tlwaelegang	tl_> w a E l E x a N
tlwaelegileng	tl_> w a E l E x i l E N
tlwaelo	tl_> w a E l O
tlwaetse	tl_> w a E ts_> E
today	t_h E d E
today	t_> O d a j
togamaano	t_> O x a m a n O
tokafadiwa	t_> O k_> a f a d i w a
tokafatsa	t_> O k_> a f a ts_> a
tokafatsang	t_> O k_> a f a ts_> a N
tokafatso	t_> O k_> a f a ts_> O
tokelo	t_> O k_> E l O
tokologo	t_> O k_> O l O x O
tokololo	t_> O k_> O l O l O
tokomane	t_> O k_> O m a n E
tokumente	t_> O k_> u m E n t_> E
tola	t_> O l a
tomagano	t_> O m a x a n O
tona	t_> O n a
tonakgolo	t_> O n a kx O l O
tons	t_h a n s
tons	t_> O n s
tony	t_h O n i
tony	t_> O J
topo	t_> O p_> O
tota	t_> O t_> a
total	t_h O t_h E l
total	t_> O t_> a l
totobaditsweng	t_> O t_> O b a d i ts_> w E N
totobetse	t_> O t_> O b E ts_> E
totšhe	t_> O tS_h E
town	t_h a n
town	t_> O w n
trade	t_h r E d
trade	t_> r a d E
trading	t_h r E d i N
trading	t_> r a d i N
traditional	t_h r E d i s E n E l
traditional	t_> r a d i t_> i O n a l
traffic	t_h r a f i k_h
transfer	t_h r a n s f a r
transfer	t_> r a n s f E r
transport	t_h r a n s p_h O t_h
transport	t_> r a n s p_> O r t_>
treaty	t_h r i t_h i
treaty	t_> r E a t_> j
tree	t_h r i
tree	t_> r E E
trees	t_h r i s
trees	t_> r E E s
ts	t_h i E s
tsa	ts_> a
tsala	ts_> a l a
tsalo	ts_> a l O
tsamae	ts_> a m a E
tsamaelana	ts_> a m a E l a n a
tsamaelane	ts_> a m a E l a n E
tsamaelang	ts_> a m a E l a N
tsamaisa	ts_> a m a i s a
tsamaisanang	ts_> a m a i s a n a N
tsamaisang	ts_> a m a i s a N
tsamaisano	ts_> a m a i s a n O
tsamaise	ts_> a m a i s E
tsamaisiwa	ts_> a m a i s i w a
tsamaisiwang	ts_> a m a i s i w a N
tsamaiso	ts_> a m a i s O
tsamaisoeesa	ts_> a m a i s O E E s a
tsamaisong	ts_> a m a i s O N
tsamaisotemothuo	ts_> a m a i s O t_> E m O t_h u O
tsamaya	ts_> a m a j a
tsamayang	ts_> a m a j a N
tsamisiwang	ts_> a m i s i w a N
tsatsi	ts_> a ts_> i
tsaya	ts_> a j a
tsayang	ts_> a j a N
tse	ts_> E
tsebe	ts_> E b E
tsebeng	ts_> E b E N
tsebentlha	ts_> E b E n tl_h a
tseelwa	ts_> E E l w a
tsekedi	ts_> E k_> E d i
tsela	ts_> E l a
tseleng	ts_> E l E N
tsena	ts_> E n a
tsene	ts_> E n E
tsenela	ts_> E n E l a
tsenelela	ts_> E n E l E l a
tsenelelo	ts_> E n E l E l O
tseneletseng	ts_> E n E l E ts_> E N
tseneng	ts_> E n E N
tsengwang	ts_> E N w a N
tsenngwa	ts_> E n N w a
tsenngwang	ts_> E n N w a N
tsenngwe	ts_> E n N w E
tseno	ts_> E n O
tsentse	ts_> E n ts_> E
tsentsho	ts_> E n ts_h O
tsentsweng	ts_> E n ts_> w E N
tsenya	ts_> E J a
tsenyelediwa	ts_> E J E l E d i w a
tsenyeletsa	ts_> E J E l E ts_> a
tsenyeletsang	ts_> E J E l E ts_> a N
tseo	ts_> E O
tsepameng	ts_> E p_> a m E N
tsereganyo	ts_> E r E x a J O
tsereganyong	ts_> E r E x a J O N
tserweng	ts_> E r w E N
tsewa	ts_> E w a
tsewang	ts_> E w a N
tsewe	ts_> E w E
tseye	ts_> E j E
tshaba	ts_h a b a
tshabafadiwa	ts_h a b a f a d i w a
tshabafatso	ts_h a b a f a ts_> O
tshabale	ts_h a b a l E
tshabang	ts_h a b a N
tshabela	ts_h a b E l a
tshabileng	ts_h a b i l E N
tshaeno	ts_h a E n O
tshameka	ts_h a m E k_> a
tshaneo	ts_h a n E O
tshedimosetso	ts_h E d i m O s E ts_> O
tshedimosetsong	ts_h E d i m O s E ts_> O N
tshegare	ts_h E x a r E
tshegatshega	ts_h E x a ts_h E x a
tshegetsa	ts_h E x E ts_> a
tshegetsang	ts_h E x E ts_> a N
tshegetso	ts_h E x E ts_> O
tshekamelo	ts_h E k_> a m E l O
tshekatsheko	ts_h E k_> a ts_h E k_> O
tshekatshekong	ts_h E k_> a ts_h E k_> O N
tshekiso	ts_h E k_> i s O
tsheko	ts_h E k_> O
tshekong	ts_h E k_> O N
tshela	ts_h E l a
tshelang	ts_h E l a N
tshele	ts_h E l E
tshelelang	ts_h E l E l a N
tshelete	ts_h E l E t_> E
tshelo	ts_h E l O
tshenolo	ts_h E n O l O
tshenye	ts_h E J E
tshenyego	ts_h E J E x O
tshenyo	ts_h E J O
tshenyong	ts_h E J O N
tshepa	ts_h E p_> a
tshepiwa	ts_h E p_> i w a
tshepo	ts_h E p_> O
tshetsana	ts_h E ts_> a n a
tshiaimiso	ts_h i a i m i s O
tshiamelo	ts_h i a m E l O
tshiamiso	ts_h i a m i s O
tshiamo	ts_h i a m O
tshika	ts_h i k_> a
tshikinyo	ts_h i k_> i J O
tshimologo	ts_h i m O l O x O
tshimologong	ts_h i m O l O x O N
tshimololo	ts_h i m O l O l O
tshingwana	ts_h i N w a n a
tshipi	ts_h i p_> i
tshireletsego	ts_h i r E l E ts_> E x O
tshireletso	ts_h i r E l E ts_> O
tshisimogo	ts_h i s i m O x O
tshisinya	ts_h i s i J a
tshitlhamololelo	ts_h i tl_h a m O l O l E l O
tshoga	ts_h O x a
tshoganyeditse	ts_h O x a J E d i ts_> E
tshoganyetso	ts_h O x a J E ts_> O
tshogile	ts_h O x i l E
tshola	ts_h O l a
tsholang	ts_h O l a N
tsholelwa	ts_h O l E l w a
tsholetsa	ts_h O l E ts_> a
tsholetse	ts_h O l E ts_> E
tsholo	ts_h O l O
tsholofelo	ts_h O l O f E l O
tsholofetso	ts_h O l O f E ts_> O
tshologa	ts_h O l O x a
tshologela	ts_h O l O x E l a
tsholwa	ts_h O l w a
tshomarelo	ts_h O m a r E l O
tshono	ts_h O n O
tshosetso	ts_h O s E ts_> O
tshositswe	ts_h O s i ts_> w E
tshotlo	ts_h O tl_> O
tshotse	ts_h O ts_> E
tshotseng	ts_h O ts_> E N
tshotsweng	ts_h O ts_> w E N
tshuba	ts_h u b a
tshupamolato	ts_h u p_> a m O l a t_> O
tshupatefo	ts_h u p_> a t_> E f O
tshupetso	ts_h u p_> E ts_> O
tshupo	ts_h u p_> O
tshutiso	ts_h u t_> i s O
tshwaela	ts_h w a E l a
tshwaetso	ts_h w a E ts_> O
tshwailweng	ts_h w a i l w E N
tshwaiwa	ts_h w a i w a
tshwana	ts_h w a n a
tshwanang	ts_h w a n a N
tshwane	ts_h w a n E
tshwanela	ts_h w a n E l a
tshwanelang	ts_h w a n E l a N
tshwanelo	ts_h w a n E l O
tshwanelong	ts_h w a n E l O N
tshwanelwa	ts_h w a n E l w a
tshwanelwang	ts_h w a n E l w a N
tshwanesteng	ts_h w a n E s t_> E N
tshwanetse	ts_h w a n E ts_> E
tshwanetseng	ts_h w a n E ts_> E N
tshwanetsweng	ts_h w a n E ts_> w E N
tshwanno	ts_h w a n n O
tshwantshangwa	ts_h w a n ts_h a N w a
tshwantshanyo	ts_h w a n ts_h a J O
tshwara	ts_h w a r a
tshwaragane	ts_h w a r a x a n E
tshwaraganya	ts_h w a r a x a J a
tshwaraganyo	ts_h w a r a x a J O
tshwarang	ts_h w a r a N
tshwaregeng	ts_h w a r E x E N
tshwarelelwa	ts_h w a r E l E l w a
tshwarelo	ts_h w a r E l O
tshwarelwa	ts_h w a r E l w a
tshwarelwe	ts_h w a r E l w E
tshwaretsweng	ts_h w a r E ts_> w E N
tshwaro	ts_h w a r O
tshwarwa	ts_h w a r w a
tshwarweng	ts_h w a r w E N
tshweetso	ts_h w E E ts_> O
tshwenngwa	ts_h w E n N w a
tshwentse	ts_h w E n ts_> E
tshwenya	ts_h w E J a
tshwenyang	ts_h w E J a N
tshwenye	ts_h w E J E
tshwenyege	ts_h w E J E x E
tshwera	ts_h w E r a
tshwereng	ts_h w E r E N
tshwerweng	ts_h w E r w E N
tshwetso	ts_h w E ts_> O
tshweu	ts_h w E u
tsi	ts_> i
tsia	ts_> i a
tsiboge	ts_> i b O x E
tsibogela	ts_> i b O x E l a
tsibogetse	ts_> i b O x E ts_> E
tsibogo	ts_> i b O x O
tsibosa	ts_> i b O s a
tsietsing	ts_> i E ts_> i N
tsietso	ts_> i E ts_> O
tsitsibanyang	ts_> i ts_> i b a J a N
tsitsintse	ts_> i ts_> i n ts_> E
tsofetse	ts_> O f E ts_> E
tsoga	ts_> O x a
tsogile	ts_> O x i l E
tsona	ts_> O n a
tsone	ts_> O n E
tsoopedi	ts_> O O p_> E d i
tsosi	ts_> O s i
tsosolosiwa	ts_> O s O l O s i w a
tsosoloso	ts_> O s O l O s O
tsotlhe	ts_> O tl_h E
tsotlhetsotlhe	ts_> O tl_h E ts_> O tl_h E
tsupamolomo	ts_> u p_> a m O l O m O
tswa	ts_> w a
tswalelo	ts_> w a l E l O
tswaletswe	ts_> w a l E ts_> w E
tswana	t_h s w E n E
tswana	ts_> w a n a
tswang	ts_> w a N
tswe	ts_> w E
tswee	ts_> w E E
tsweetswe	ts_> w E E ts_> w E
tsweetswee	ts_> w E E ts_> w E E
tswela	ts_> w E l a
tswelang	ts_> w E l a N
tswele	ts_> w E l E
tswelediwa	ts_> w E l E d i w a
tswelela	ts_> w E l E l a
tswelelang	ts_> w E l E l a N
tswelelapele	ts_> w E l E l a p_> E l E
tswelelo	ts_> w E l E l O
tsweletsa	ts_> w E l E ts_> a
tsweletseng	ts_> w E l E ts_> E N
tsweletsong	ts_> w E l E ts_> O N
tsweletswa	ts_> w E l E ts_> w a
tswelwa	ts_> w E l w a
tsweng	t_> s w E N
tswetse	ts_> w E ts_> E
tswetswe	ts_> w E ts_> w E
tuediso	t_> u E d i s O
tuelo	t_> u E l O
tulo	t_> u l O
tulong	t_> u l O N
tumalano	t_> u m a l a n O
tumalanong	t_> u m a l a n O N
tumelano	t_> u m E l a n O
tumelelano	t_> u m E l E l a n O
tumelelo	t_> u m E l E l O
tumelesego	t_> u m E l E s E x O
tumellano	t_> u m E l l a n O
tumelo	t_> u m E l O
turing	t_h j u r i N
turing	t_> u r i N
turkish	t_h a k_h i s
turkish	t_> u r k_> i s
tv	t_>
tv	t_h i f i
twantsha	ts_> w a n ts_h a
twe	ts_> w E
tšhelete	tS_h E l E t_> E
tšhono	tS_h O n O
u	j u
uif	u i f
umakiliweng	u m a k_> i l i w E N
umakilweng	u m a k_> i l w E N
umakiwa	u m a k_> i w a
umakiwang	u m a k_> i w a N
union	j u n E n
union	u n i O n
united	j u n a t_h E d
united	u n i t_> E d
university	j u n i f a s E t_h i
university	u n i E r i t_> j
us	a s
us	u s
usa	j u E s E
usa	u s a
utlwa	u tl_> w a
utlwala	u tl_> w a l a
utlwalang	u tl_> w a l a N
utlwane	u tl_> w a n E
utlwang	u tl_> w a N
utlwe	u tl_> w E
utlwelele	u tl_> w E l E l E
utlwelelwang	u tl_> w E l E l w a N
utlwile	u tl_> w i l E
utlwisa	u tl_> w i s a
utlwisang	u tl_> w i s a N
utswa	u ts_> w a
utswitswe	u ts_> w i ts_> w E
v	f i
valhalla	a l a l l a
valhalla	f a l h a l E
vasco	f a s k_h O
vat	a t_>
vat	f a t_h
version	E r i O n
version	f a s E n
video	f i d E E
video	i d E O
vidio	i d i O
violations	f a E l E s E n s
violations	i O l a t_> i O n s
vip	i p_>
vista	f E s t_h E
vista	i s t_> a
vitae	i t_> a E
w	d a b E l j u
wa	w a
wabots	w a b O ts_>
wagamang	w a x a m a N
wall	w a l l
wall	w O l
wana	w a n a
war	w a r
war	w O r
watch	w O tS_h
we	w E
we	w i
web	w E b
webosaete	w E b O s a E t_> E
webosaeteng	w E b O s a E t_> E N
websaete	w E b a E t_> E
websaeteng	w E b a E t_> E N
website	w E b i t_> E
website	w E b s a t_h
wee	w E E
wee	w i
weee	w E E E
weeee	w E E E E
weeeeena	w E E E E E n a
wela	w E l a
welang	w E l a N
wele	w E l E
wena	w E n a
west	w E s t_>
west	w E s t_h
western	w E s t_> E r n
western	w E s t_h E n
wetse	w E ts_> E
wetsho	w E ts_h O
white	w a t_h
white	w h i t_> E
wide	w a d
wide	w i d E
wili	w i l i
williams	w E l E m s
williams	w i l l i a m
winner	w E n E r
winner	w i n n E r
winners	w E n E s
winners	w i n n E r
winning	w E n i N
winning	w i n n i N
workers	w a k_h E s
workers	w O r k_> E r
world	w a l d
world	w O r l d
writer	r a t_h E r
writer	w r i t_> E r
writers	r a t_h E s
writers	w r i t_> E r
wua	w u a
x	E k_h s
y	w a
ya	j a
yagago	j a x a x O
yaloago	j a l O a x O
yang	j a N
yankees	j a n k_> E E s
yankees	j a N k_h i s
yasetšhaba	j a s E tS_h a b a
yathulaganyo	j a t_h u l a x a J O
yay	j a j
ye	j E
ye	j i
year	j a r
year	j E a r
years	j a s
years	j E a r
yo	j O
yole	j O l E
yom	j O m
yona	j O n a
yone	j O n E
yoo	j O O
york	j O k_h
york	j O r k_>
yotlhe	j O tl_h E
yunibesithing	j u n i b E s i t_h i N
yunifomo	j u n i f O m O
yuniti	j u n i t_> i
zealand	s i l E n d
zimbabwe	s E m b a b w E
ša	S a
