a	E
abab	a b a b
aborathari	a b O r a t_h a r i
aborithari	a b O r i t_h a r i
abrahamu	a b r a h\ a m u
abramu	a b r a m u
aburahamu	a b u r a h\ a m u
academy	E k_h a d E m i
act	a k_h t_h
actual	a k_h tS_h O l
adi	a d_0Z i
adult	a d_0Z u l t_>
adult	a d a l t_h
advantage	a d_0Z v a n t_> a g E
advantage	E d v a n t_h i d_0Z
adza	a dz a
adzhenda	a dz h\ E n d a
adziwa	a dz i w a
adzo	a dz O
adzula	a dz u l a
adzwa	a dz w a
adzwaho	a dz w a h\ O
afha	a p\ a
afhadza	a p\ a dz a
afhio	a p\ i O
afho	a p\ O
afidavithi	a f i d_0Z a v i t_h i
afidaviti	a f i d_0Z a v i t_> i
africa	a f r i k_h E
african	a f r i k_h E n
afrika	a p\ r i k_> a
afurika	a f u r i k_> a
afurikatshipembe	a f u r i k_> a tS_h i p_> E m b E
aganana	a g a n a n a
agasi	a g a s i
age	a g E
age	E d_0Z
ago	a g O
ago	E g O
agreement	a g r E E m E n t_>
agreement	E g r i m E n t_h
agreements	a g r E E m E n ts_>
agreements	E g r i m E n t_h s
agri	a g r i
ahe	a h\ E
ahee	a h\ E E
ahelelo	a h\ E l E l O
ahisana	a h\ i s a n a
aho	a h\ O
ai	a i
aids	a i d_0Z s
aids	E d z
aifa	a i f a
aini	a i n i
air	a i r
air	E r
airlines	a i r l i n E s
airlines	E l a n z
aisana	a i s a n a
aisentsi	a i s E n ts_> i
akademi	a k_> a d_0Z E m i
akani	a k_> a n i
akhademia	a k_h a d_0Z E m i a
akhaivi	a k_h a i v i
akhaunthu	a k_h a u n t_h u
akhauthu	a k_h a u t_h u
akhouthu	a k_h O u t_h u
al	a l
aladzi	a l a dz i
alafha	a l a p\ a
alafhiwa	a l a p\ i w a
alaho	a l a h\ O
ale	a l E
ale	E l
alexander	a l E g z a n d E r
alexander	a l E x a n d E r
ali	a l i
alikhoholi	a l i k_h O h\ O l i
alula	a l u l a
alumni	a l u m n i
alumni	E l a m n a
alusa	a l u s a
aluse	a l u s E
alusiwa	a l u s i w a
aluswa	a l u sw a
alutshedza	a l u tS_h E dz a
alutshedziwa	a l u tS_h E dz i w a
alutshedzwa	a l u tS_h E dz w a
alutshedzwaho	a l u tS_h E dz w a h\ O
alutshela	a l u tS_h E l a
aluwa	a l u w a
aluwani	a l u w a n i
aluwe	a l u w E
ama	a m a
amara	a m a r a
amba	a m b a
ambadzifhele	a m b a dz i p\ E l E
ambaho	a m b a h\ O
ambani	a m b a n i
ambara	a m b a r a
ambarelaho	a m b a r E l a h\ O
ambariwa	a m b a r i w a
ambarwaho	a m b a r w a h\ O
ambe	a m b E
ambedzana	a m b E dz a n a
ambela	a m b E l a
ambelaho	a m b E l a h\ O
ambeswa	a m b E sw a
ambi	a m b i
ambisa	a m b i s a
ambiwa	a m b i w a
ambiwaho	a m b i w a h\ O
ambiwe	a m b i w E
ambulula	a m b u l u l a
ambwa	a m b w a
amendiwa	a m E n d i w a
america	E m E r i k_h E
american	E m E r i k_h E n
amerika	a m E r i k_> a
aminomi	a m i n O m i
amuthu	a m u t_h u
anana	a n a n a
ananya	a n a J a
anavhuwaho	a n a B u w a h\ O
anba	a n b a
and	a n d
anda	a n d a
andadza	a n d a dz a
andadzwa	a n d a dz w a
andaniwaho	a n d a n i w a h\ O
andesaho	a n d E s a h\ O
andiswa	a n d i sw a
ane	a n E
anea	a n E a
anekidzha	a n E k_> i dz h\ a
aneo	a n E O
anetshela	a n E tS_h E l a
anga	a n g a
angana	a n g a n a
anganala	a n g a n a l a
anganedza	a n g a n E dz a
anganedzaho	a n g a n E dz a h\ O
anganedzwa	a n g a n E dz w a
anganela	a n g a n E l a
anganelaho	a n g a n E l a h\ O
anganelana	a n g a n E l a n a
anganelano	a n g a n E l a n O
angano	a n g a n O
anganya	a n g a J a
anganyela	a n g a J E l a
anganyi	a n g a J i
anganyisa	a n g a J i s a
anganyiswahona	a n g a J i sw a h\ O n a
anganywa	a n g a J w a
angaredza	a n g a r E dz a
angaredzaho	a n g a r E dz a h\ O
angaredziwa	a n g a r E dz i w a
angaredzwa	a n g a r E dz w a
ango	a n g O
angula	a n g u l a
aniwa	a n i w a
aniwaho	a n i w a h\ O
ano	a n O
anu	a n u
anwa	a n w a
anya	a J a
anza	a n z a
anzela	a n z E l a
anzeli	a n z E l i
anzelwa	a n z E l w a
anzi	a n z i
anḓadza	a n d a dz a
anḓadzwa	a n d a dz w a
anḓana	a n d a n a
apex	a p_> E x
apex	E p_h E k_h s
aphila	a p_h i l a
aphili	a p_h i l i
apo	a p_> O
apostolic	a p_h E s t_h O l i k_h
apply	a p_> p_> l j
apply	E p_h l a
apula	a p_> u l a
ara	a r a
arabic	a r E b i k_h
arali	a r a l i
aramudza	a r a m u dz a
are	a r
are	a r E
area	a r E a
area	E r E
ari	a r i
armed	a m d
armed	a r m E d_0Z
armenian	a m i n E n
armenian	a r m E n i a n
army	a m i
army	a r m j
artery	a r t_> E r j
artery	a t_h E r i
arthritis	a f r a t_h E s
arthritis	a r t_h r i t_> i s
arts	a r ts_>
arts	a t_h s
asa	a s a
asean	a s E a n
asean	a s E n
asesa	a s E s a
ashu	a S u
asi	a s i
asia	a s i a
asia	E d_0Z E
asian	a s i a n
asian	E d_0Z E n
asnath	a s n a t_h
association	E s O s i E s E n
ataf	a t_> a p\
athatshiwa	a t_h a tS_h i w a
athi	a t_h i
athifomo	a t_h i f O m O
athiri	a t_h i r i
athu	a t_h u
atiki	a t_> i k_> i
atlantic	a t_h l a n t_h i k_h
au	a u
au	O
august	a u g u s t_>
august	O g a s t_h
auri	a u r i
australian	a u s t_> r a l i a n
australian	O s t_h r E l E n
author	a u t_h O r
author	O f E r
authority	a u t_h O r i t_h
authority	O f O r E t_h i
avha	a B a
avhanya	a B a J a
avhanyisa	a B a J i s a
avhavha	a B a B a
avhavho	a B a B O
avho	a B O
avhudi	a B u d_0Z i
avhui	a B u i
avhuwa	a B u w a
avhuḓi	a B u d i
awara	a w a r a
award	a w a r d_0Z
award	E w O d
awe	a w E
awe	O
awedzeni	a w E dz E n i
awela	a w E l a
aya	a j a
ayo	a j O
ayodini	a j O d_0Z i n i
ayoni	a j O n i
ayoo	a j O O
azwo	a zw O
aḓirese	a d i r E s E
aḓiresi	a d i r E s i
aḽa	a l a
aṋu	a n u
aṱama	a t_> a m a
b	b i
ba	b a
ba	b i E
baa	b a
baa	b a a
baba	b a b a
bada	b a d_0Z a
badani	b a d_0Z a n i
badekanyana	b a d_0Z E k_> a J a n a
badela	b a d_0Z E l a
badele	b a d_0Z E l E
badeliswaho	b a d_0Z E l i sw a h\ O
badeliwa	b a d_0Z E l i w a
badelwa	b a d_0Z E l w a
badelwaho	b a d_0Z E l w a h\ O
badelwe	b a d_0Z E l w E
badelwi	b a d_0Z E l w i
badelwiho	b a d_0Z E l w i h\ O
bafta	b a f t_h E
bafta	b a p\ t_> a
baindiwa	b a i n d i w a
baisigila	b a i s i g i l a
baka	b a k_> a
bako	b a k_> O
bakoni	b a k_> O n i
bala	b a l a
balaga	b a l a g a
balavhali	b a l a B a l i
baleaho	b a l E a h\ O
balelwa	b a l E l w a
bambela	b a m b E l a
bambiri	b a m b i r i
bammbela	b a m b E l a
bammbiri	b a m b i r i
banda	b a n d a
bank	b a n k_>
bank	b a N k_h
banks	b a N k_h s
banks	b a n k_> s
bannda	b a n n d a
bannga	b a n n g a
banngaho	b a n n g a h\ O
banngani	b a n n g a n i
barack	b a r E k_h
baseball	b a s E b a l l
baseball	b E s b O l
based	b a s E d_0Z
based	b E s t_h
basela	b a s E l a
basi	b a s i
bata	b a t_> a
batho	b a t_h O
battery	b a t_h E r i
battery	b a t_> t_> E r j
bay	b a j
bay	b E
bayodaivesithi	b a j O d_0Z a i v E s i t_h i
bayothekhino	b a j O t_h E k_h i n O
baḓamandiusetshe	b a d a m a n d i u s E tS_h E
baṱa	b a t_> a
bd	b i d i
beba	b E b a
bebiwaho	b E b i w a h\ O
bebwa	b E b w a
bee	b E E
bee	b i
bege	b E g E
beiḽi	b E i l i
bele	b E l E
beledza	b E l E dz a
bell	b E l
bell	b E l l
benin	b E n i n
benin	b i n i n
bennde	b E n n d E
bere	b E r E
berne	b E r n E
besekuwe	b E s E k_> u w E
bete	b E t_> E
bi	b i
bida	b i d_0Z a
bika	b i k_> a
bikela	b i k_> E l a
biko	b i k_> O
bikwa	b i k_> w a
bili	b i l i
billion	b E l E N
billion	b i l l i O n
bilufhala	b i l u p\ a l a
bin	b E n
bin	b i n
binary	b a n E r i
binary	b i n a r j
bindu	b i n d u
bindudza	b i n d u dz a
bindudzelana	b i n d u dz E l a n a
bindudzwa	b i n d u dz w a
bindula	b i n d u l a
binya	b i J a
biological	b a E l O d_0Z i k_h E l
biothekhino	b i O t_h E k_h i n O
biro	b i r O
bisi	b i s i
bisimisi	b i s i m i s i
bisimusi	b i s i m u s i
bivhili	b i B i l i
bloc	b l O k_h
blood	b l a d
blood	b l O O d_0Z
bo	b O
bodo	b O d_0Z O
bodzanḓala	b O dz a n d a l a
bogisi	b O g i s i
bohwana	b O h\ w a n a
bola	b O l a
bommba	b O m b a
bond	b O n d
bono	b O n O
bonya	b O J a
bonyongo	b O J O n g O
boston	b O s t_h E n
boston	b O s t_> O n
boy	b O
boy	b O j
boḓelo	b O d E l O
bran	b r a n
bran	b r E n
brazil	b r a z i l
brazil	b r E z i l
british	b r E t_h i s
british	b r i t_> i S
bu	b u
bua	b u a
buccaneers	b a k_h E n E z
bud	b a d
bud	b u d_0Z
bufho	b u p\ O
bugu	b u g u
bugupfarwa	b u g u p_> f a r w a
bugwana	b u g w a n a
buka	b u k_> a
bula	b u l a
bulani	b u l a n i
bulasi	b u l a s i
bulasini	b u l a s i n i
bule	b u l E
buletshedzani	b u l E tS_h E dz a n i
buli	b u l i
buliwa	b u l i w a
buliwaho	b u l i w a h\ O
buloko	b u l O k_> O
bulugwane	b u l u g w a n E
buluni	b u l u n i
buluu	b u l u
bulwa	b u l w a
bulwaho	b u l w a h\ O
bune	b u n E
bunga	b u n g a
bungani	b u n g a n i
burandi	b u r a n d i
burauza	b u r a u z a
buraweni	b u r a w E n i
buronikhitisi	b u r O n i k_h i t_> i s i
buthano	b u t_h a n O
buḓo	b u d O
bva	b v a
bvafhi	b v a p\ i
bvaho	b v a h\ O
bvalelwa	b v a l E l w a
bvalelwe	b v a l E l w E
bvalwa	b v a l w a
bvani	b v a n i
bve	b v E
bvela	b v E l a
bvelaho	b v E l a h\ O
bvelaphana	b v E l a p_h a n a
bvelaphanda	b v E l a p_h a n d a
bvelaphanḓa	b v E l a p_h a n d a
bvele	b v E l E
bveledza	b v E l E dz a
bveledze	b v E l E dz E
bveledzisa	b v E l E dz i s a
bveledziswa	b v E l E dz i sw a
bveledziwa	b v E l E dz i w a
bveledzwa	b v E l E dz w a
bveledzwaho	b v E l E dz w a h\ O
bveledzwe	b v E l E dz w E
bvelela	b v E l E l a
bvelelaho	b v E l E l a h\ O
bvelele	b v E l E l E
bvesa	b v E s a
bvi	b v i
bvisa	b v i s a
bvise	b v i s E
bvisela	b v i s E l a
bviselwa	b v i s E l w a
bvisiho	b v i s i h\ O
bvisiswa	b v i s i sw a
bvisiwa	b v i s i w a
bviswa	b v i sw a
bviswaho	b v i sw a h\ O
bviswe	b v i sw E
bviwa	b v i w a
bvu	b v u
bvukululela	b v u k_> u l u l E l a
bvula	b v u l a
bvuledze	b v u l E dz E
bvuma	b v u m a
bvumela	b v u m E l a
bvumo	b v u m O
bwa	b w a
bwelwa	b w E l w a
bwiwa	b w i w a
bwululwa	b w u l u l w a
ca	k_h a
call	k_h O l
canadian	k_h E n E d E n
caribbean	k_h E r E b i E n
cathode	k_h a f O d
catholic	k_h a f l i k_h
catholics	k_h a f l i k_h s
cbnrm	k_h b n m
cbnrm	s i b i E n a r E m
cc	k_h
cc	s i s i
cd	k_h d
cd	s i d i
cells	s E l z
central	s E n t_h r E l
centrally	s E n t_h r E l i
centre	s E n t_h E r
century	s E n tS_h E r i
chain	tS_h E n
championship	tS_h a m p_h E n s E p_h
charles	tS_h a l z
chicago	s i k_h a g O
chiefs	tS_h i f s
chili	tS_h E l i
china	tS_h a n E
church	tS_h a tS_h
churches	tS_h a tS_h E z
cite	s a t_h
city	s E t_h i
civil	s E v E l
clarify	k_h l a r E f a
close	k_h l O s
clubs	k_h l a b z
cma	k_h m E
coast	k_h O s t_h
code	k_h O d
cold	k_h O l d
color	k_h a l E r
command	k_h E m a n d
committee	k_h E m E t_h i
common	k_h O m E n
community	k_h E m j u n E t_h i
company	k_h a m p_h E n i
compression	k_h E m p_h r E s E n
comsec	k_h E m s E k_h
concepts	k_h O n s E p_h t_h s
conference	k_h O n f E r E n s
congo	k_h O N g O
congress	k_h O N g r E s
console	k_h O n s O l
content	k_h O n t_h E n t_h
continental	k_h O n t_h i n E n t_h E l
convention	k_h E n v E n s E n
cooperate	k_h O O p_h E r E t_h
cooperative	k_h O O p_h E r E t_h E v
coppola	k_h O p_h E l E
coptic	k_h O p_h t_h i k_h
coronary	k_h O r E n E r i
cosmic	k_h O z m i k_h
council	k_h a n s E l
countries	k_h a n t_h r i z
coup	k_h u
court	k_h O t_h
cross	k_h r O s
cup	k_h a p_h
customs	k_h a s t_h E m z
d	d i
da	d_0Z a
da	d a
da	d i E
dacst	d a k_> s t_>
dacst	d i E s i E s t_> i
dadamala	d_0Z a d_0Z a m a l a
dadza	d_0Z a dz a
dadze	d_0Z a dz E
dadziwa	d_0Z a dz i w a
dadziwaho	d_0Z a dz i w a h\ O
dafitha	d_0Z a f i t_h a
daha	d_0Z a h\ a
dahe	d_0Z a h\ E
dahi	d_0Z a h\ i
dahiwe	d_0Z a h\ i w E
dairekhithoreithi	d_0Z a i r E k_h i t_h O r E i t_h i
daivesithi	d_0Z a i v E s i t_h i
daiḽekithi	d_0Z a i l E k_> i t_h i
daka	d_0Z a k_> a
dakalo	d_0Z a k_> a l O
dala	d_0Z a l a
dalaho	d_0Z a l a h\ O
dalela	d_0Z a l E l a
dalelaho	d_0Z a l E l a h\ O
dalele	d_0Z a l E l E
dali	d_0Z a l i
dali	d E l a
damuni	d_0Z a m u n i
danga	d_0Z a n g a
dangani	d_0Z a n g a n i
dantsa	d_0Z a n ts_> a
data	d_0Z a t_> a
data	d E t_h E
database	d_0Z a t_> a b a s E
database	d E t_h E b E s
date	d_0Z a t_> E
date	d E t_h
dathabeisi	d_0Z a t_h a b E i s i
datumu	d_0Z a t_> u m u
davha	d_0Z a B a
davhana	d_0Z a B a n a
davhi	d_0Z a B i
davhidzana	d_0Z a B i dz a n a
de	d_0Z E
de	d E
dead	d_0Z E a d_0Z
dead	d E d
deat	d_0Z E a t_>
december	d i s E m b E r
deeds	d_0Z E E d_0Z s
deeds	d i d z
deedsweb	d_0Z E E d_0Z sw E b
dela	d_0Z E l a
deme	d_0Z E m E
democratic	d E m E k_h r a t_h i k_h
demokhirasi	d_0Z E m O k_h i r a s i
demokhrasi	d_0Z E m O k_h r a s i
demokirasi	d_0Z E m O k_> i r a s i
dende	d_0Z E n d E
dendele	d_0Z E n d E l E
denga	d_0Z E n g a
density	d_0Z E n s i t_h
density	d E n s E t_h i
denzhe	d_0Z E n Z E
department	d_0Z E p_> a r t_> m E n t_>
department	d i p_h a t_h m E n t_h
development	d_0Z E v E l O p_> m E n t_>
development	d i v E l E p_h m E n t_h
di	d_0Z i
di	d a
diamba	d_0Z i a m b a
diambela	d_0Z i a m b E l a
diambulula	d_0Z i a m b u l u l a
diana	d_0Z i a n a
diana	d E E n E
dibadekanya	d_0Z i b a d_0Z E k_> a J a
dibvisa	d_0Z i b v i s a
didina	d_0Z i d_0Z i n a
didine	d_0Z i d_0Z i n E
didzhithala	d_0Z i dz h\ i t_h a l a
difanyisa	d_0Z i f a J i s a
difara	d_0Z i f a r a
diffusion	d_0Z i p\ f u s i O n
diffusion	d E f j u d_0Z E n
difhulufhela	d_0Z i p\ u l u p\ E l a
digirii	d_0Z i g i r i i
digital	d_0Z i g i t_> a l
digital	d i d_0Z E t_h E l
diimisaho	d_0Z i i m i s a h\ O
diimisela	d_0Z i i m i s E l a
diimiselaho	d_0Z i i m i s E l a h\ O
diitela	d_0Z i i t_> E l a
dikhipushin	d_0Z i k_h i p_> u S i n
dikitela	d_0Z i k_> i t_> E l a
dikumedzele	d_0Z i k_> u m E dz E l E
dilugisela	d_0Z i l u g i s E l a
dimani	d_0Z i m a n i
dimbanyika	d_0Z i m b a J i k_> a
dimokirasi	d_0Z i m O k_> i r a s i
dimvumvusa	d_0Z i m v u m v u s a
dina	d_0Z i n a
dinaho	d_0Z i n a h\ O
dinalea	d_0Z i n a l E a
dinangela	d_0Z i n a n g E l a
dindi	d_0Z i n d i
dinesa	d_0Z i n E s a
dini	d_0Z i n i
dinwa	d_0Z i n w a
dipeni	d_0Z i p_> E n i
dipfa	d_0Z i p_> f a
diphina	d_0Z i p_h i n a
diphosita	d_0Z i p_h O s i t_> a
diphosithi	d_0Z i p_h O s i t_h i
diplomatic	d E p_h l E m a t_h i k_h
direct	d i r E k_h t_h
directors	d i r E k_h t_h E z
diresi	d_0Z i r E s i
disa	d_0Z i s a
disease	d_0Z i s E a s E
disease	d i z i z
disedza	d_0Z i s E dz a
disendekaho	d_0Z i s E n d E k_> a h\ O
dishumele	d_0Z i S u m E l E
disney	d_0Z i s n E j
disney	d E z n i
diswa	d_0Z i sw a
dithogomela	d_0Z i t_h O g O m E l a
ditika	d_0Z i t_> i k_> a
ditikaho	d_0Z i t_> i k_> a h\ O
ditshidza	d_0Z i tS_h i dz a
ditutuwedzeni	d_0Z i t_> u t_> u w E dz E n i
div	d_0Z i B
divha	d_0Z i B a
divhadea	d_0Z i B a d_0Z E a
divhadza	d_0Z i B a dz a
divhadzwa	d_0Z i B a dz w a
divhai	d_0Z i B a i
divhalei	d_0Z i B a l E i
divhashango	d_0Z i B a S a n g O
divhavhupo	d_0Z i B a B u p_> O
divhazwakale	d_0Z i B a zw a k_> a l E
divhe	d_0Z i B E
divhea	d_0Z i B E a
divhei	d_0Z i B E i
divhi	d_0Z i B i
divhiwa	d_0Z i B i w a
divhonadze	d_0Z i B O n a dz E
dizili	d_0Z i z i l i
diḽivara	d_0Z i l i v a r a
do	d_0Z O
do	d O
doa	d_0Z O a
doba	d_0Z O b a
doc	d O k_h
dodombedzwe	d_0Z O d_0Z O m b E dz w E
dokhethe	d_0Z O k_h E t_h E
dokhumenthe	d_0Z O k_h u m E n t_h E
dokotela	d_0Z O k_> O t_> E l a
dokotelakha	d_0Z O k_> O t_> E l a k_h a
domba	d_0Z O m b a
dombani	d_0Z O m b a n i
domboni	d_0Z O m b O n i
domestic	d E m E s t_h i k_h
donolela	d_0Z O n O l E l a
dovha	d_0Z O B a
dovhe	d_0Z O B E
dovheni	d_0Z O B E n i
dovholola	d_0Z O B O l O l a
dovhololi	d_0Z O B O l O l i
dovhololwa	d_0Z O B O l O l w a
dovhoni	d_0Z O B O n i
doweleaho	d_0Z O w E l E a h\ O
dpsa	d i p_h i E s E
dsi	d_0Z s i
dti	d_0Z t_> i
dubo	d_0Z u b O
dudedze	d_0Z u d_0Z E dz E
dudela	d_0Z u d_0Z E l a
duga	d_0Z u g a
dugudzha	d_0Z u g u dz h\ a
dumasi	d_0Z u m a s i
dumbekanya	d_0Z u m b E k_> a J a
durela	d_0Z u r E l a
dutch	d a tS_h
duvha	d_0Z u B a
dwadze	d w a dz E
dwadzetshifu	d w a dz E tS_h i f u
dyambeu	J\ a m b E u
dz	d i z E t_h
dz	d i z i
dza	dz a
dzadzo	dz a dz O
dzama	dz a m a
dzanga	dz a n g a
dzangalelo	dz a n g a l E l O
dzangano	dz a n g a n O
dzanu	dz a n u
dzao	dz a O
dzapo	dz a p_> O
dzashu	dz a S u
dzau	dz a u
dzavho	dz a B O
dzavhuddi	dz a B u d_0Z d_0Z i
dzavhudi	dz a B u d_0Z i
dzavhui	dz a B u i
dzavhuḓi	dz a B u d i
dzawe	dz a w E
dzawedza	dz a w E dz a
dzawo	dz a w O
dzayo	dz a j O
dzazwo	dz a zw O
dzaḽo	dz a l O
dzaṋu	dz a n u
dzaṱa	dz a t_> a
dze	dz E
dzema	dz E m a
dzenedzi	dz E n E dz i
dzenedziḽa	dz E n E dz i l a
dzenedzo	dz E n E dz O
dzengama	dz E n g a m a
dzgmo	d i z E t_h d_0Z i E m O
dzgmo	d i z i d_0Z i E m O
dzhakate	dz h\ a k_> a t_> E
dzhalagoma	dz h\ a l a g O m a
dzhango	dz h\ a n g O
dzhangoni	dz h\ a n g O n i
dzhara	dz h\ a r a
dzhege	dz h\ E g E
dzhele	dz h\ E l E
dzhena	dz h\ E n a
dzhenaho	dz h\ E n a h\ O
dzhenalela	dz h\ E n a l E l a
dzhende	dz h\ E n d E
dzhendedzi	dz h\ E n d E dz i
dzhene	dz h\ E n E
dzhenela	dz h\ E n E l a
dzhenelela	dz h\ E n E l E l a
dzhenelelana	dz h\ E n E l E l a n a
dzhenelelesaho	dz h\ E n E l E l E s a h\ O
dzhenelelwa	dz h\ E n E l E l w a
dzhenelwa	dz h\ E n E l w a
dzhenerala	dz h\ E n E r a l a
dzheni	dz h\ E n i
dzheniho	dz h\ E n i h\ O
dzhenisa	dz h\ E n i s a
dzhenisaho	dz h\ E n i s a h\ O
dzhenisani	dz h\ E n i s a n i
dzhenise	dz h\ E n i s E
dzheniswa	dz h\ E n i sw a
dzheniswaho	dz h\ E n i sw a h\ O
dzheniwa	dz h\ E n i w a
dzhenwa	dz h\ E n w a
dzheṅwa	dz h\ E n w a
dzhia	dz h\ i a
dzhiaho	dz h\ i a h\ O
dzhie	dz h\ i E
dzhiela	dz h\ i E l a
dzhiele	dz h\ i E l E
dzhieliwa	dz h\ i E l i w a
dzhielwa	dz h\ i E l w a
dzhielwaho	dz h\ i E l w a h\ O
dzhielwe	dz h\ i E l w E
dzhielwi	dz h\ i E l w i
dzhiiho	dz h\ i i h\ O
dzhiiwa	dz h\ i i w a
dzhiiwaho	dz h\ i i w a h\ O
dzhiiwi	dz h\ i i w i
dzhishere	dz h\ i S E r E
dzhiwa	dz h\ i w a
dzhiwaho	dz h\ i w a h\ O
dzhiwi	dz h\ i w i
dzhoga	dz h\ O g a
dzhoina	dz h\ O i n a
dzi	dz i
dziaho	dz i a h\ O
dziakhaunthu	dz i a k_h a u n t_h u
dzibada	dz i b a d_0Z a
dzibaisigila	dz i b a i s i g i l a
dzibammbiri	dz i b a m b i r i
dzibee	dz i b E E
dzibena	dz i b E n a
dziberi	dz i b E r i
dzibiriki	dz i b i r i k_> i
dzibisi	dz i b i s i
dzibodara	dz i b O d_0Z a r a
dzibugu	dz i b u g u
dzibuguni	dz i b u g u n i
dzibulasini	dz i b u l a s i n i
dzibulege	dz i b u l E g E
dzibureiḽi	dz i b u r E i l i
dziburotsha	dz i b u r O tS_h a
dzidokhumennde	dz i d_0Z O k_h u m E n n d E
dzidoroboni	dz i d_0Z O r O b O n i
dzidsp	d z i d i E s p_> i
dzidzivhadza	dz i dz i B a dz a
dzidzivhala	dz i dz i B a l a
dzifaiburoni	dz i f a i b u r O n i
dzifaini	dz i f a i n i
dzifanyisedzele	dz i f a J i s E dz E l E
dzifeme	dz i f E m E
dzifesitivala	dz i f E s i t_> i v a l a
dzifhio	dz i p\ i O
dzifilimu	dz i f i l i m u
dzifomo	dz i f O m O
dzifuloro	dz i f u l O r O
dzigaratshini	dz i g a r a tS_h i n i
dzigebisi	dz i g E b i s i
dzigiranthi	dz i g i r a n t_h i
dzigoloi	dz i g O l O i
dzigurannḓa	dz i g u r a n n d a
dzihelikhophutha	dz i h\ E l i k_h O p_h u t_h a
dzihingo	dz i h\ i n g O
dzihoda	dz i h\ O d_0Z a
dziinthaviwu	dz i i n t_h a v i w u
dziinzhinia	dz i i n Z i n i a
dzika	dz i k_> a
dzike	dz i k_> E
dzikhaedu	dz i k_h a E d_0Z u
dzikhaendu	dz i k_h a E n d u
dzikhakhathi	dz i k_h a k_h a t_h i
dzikhaladzi	dz i k_h a l a dz i
dzikhali	dz i k_h a l i
dzikhamera	dz i k_h a m E r a
dzikhamphani	dz i k_h a m p_h a n i
dzikhare	dz i k_h a r E
dzikhareni	dz i k_h a r E n i
dzikhasi	dz i k_h a s i
dzikhasiama	dz i k_h a s i a m a
dzikhasitama	dz i k_h a s i t_> a m a
dzikhasiṱama	dz i k_h a s i t_> a m a
dzikhebabu	dz i k_h E b a b u
dzikhemikhala	dz i k_h E m i k_h a l a
dzikheroti	dz i k_h E r O t_> i
dzikhetho	dz i k_h E t_h O
dzikhonani	dz i k_h O n a n i
dzikhondomo	dz i k_h O n d O m O
dzikhondomu	dz i k_h O n d O m u
dzikhonferentsi	dz i k_h O n f E r E n ts_> i
dzikhophorethivi	dz i k_h O p_h O r E t_h i v i
dzikhoso	dz i k_h O s O
dzikhothe	dz i k_h O t_h E
dzikhumbelo	dz i k_h u m b E l O
dzikilabu	dz i k_> i l a b u
dzikiliniki	dz i k_> i l i n i k_> i
dzikiḽiniki	dz i k_> i l i n i k_> i
dzikomiti	dz i k_> O m i t_> i
dzikoniraka	dz i k_> O n i r a k_> a
dzilafho	dz i l a p\ O
dzilinganaho	dz i l i n g a n a h\ O
dzima	dz i m a
dzimafini	dz i m a f i n i
dzimana	dz i m a n a
dzimauli	dz i m a u l i
dzimbadelo	dz i m b a d_0Z E l O
dzimbado	dz i m b a d_0Z O
dzimbandelo	dz i m b a n d E l O
dzimbekanyamishumo	dz i m b E k_> a J a m i S u m O
dzimbekanyamushumo	dz i m b E k_> a J a m u S u m O
dzimbenzhelele	dz i m b E n Z E l E l E
dzimbeu	dz i m b E u
dzimbilaelo	dz i m b i l a E l O
dzimbilo	dz i m b i l O
dzimbilu	dz i m b i l u
dzimbofho	dz i m b O p\ O
dzimbudziso	dz i m b u dz i s O
dzimbuelo	dz i m b u E l O
dzimedala	dz i m E d_0Z a l a
dzimelwa	dz i m E l w a
dziminis	dz i m i n i s
dziminisiṱa	dz i m i n i s i t_> a
dzimiwa	dz i m i w a
dzimmbwa	dz i m b w a
dzimpfu	dz i m p_> f u
dzimvalo	dz i m v a l O
dzin	d z i E n
dzina	dz i n a
dzinawa	dz i n a w a
dzindaulo	dz i n d a u l O
dzindelaho	dz i n d E l a h\ O
dzindima	dz i n d i m a
dzindingo	dz i n d i n g O
dzine	dz i n E
dzinga	dz i n g a
dzinginya	dz i n g i J a
dzinginyea	dz i n g i J E a
dzinginyisa	dz i n g i J i s a
dzinginywa	dz i n g i J w a
dzinginywaho	dz i n g i J w a h\ O
dzingo	dz i n g O
dzingu	dz i n g u
dzinn	dz i n n
dzinnu	dz i n n u
dzinnḓu	dz i n n d u
dzinwe	dz i n w E
dziofisi	dz i O f i s i
dziolimpiki	dz i O l i m p_> i k_> i
dzipfanelo	dz i p_> f a n E l O
dziphakha	dz i p_h a k_h a
dziphambano	dz i p_h a m b a n O
dziphanele	dz i p_h a n E l E
dzipharashuthi	dz i p_h a r a S u t_h i
dzipholisi	dz i p_h O l i s i
dziphosita	dz i p_h O s i t_> a
dziphoḽisi	dz i p_h O l i s i
dziphukha	dz i p_h u k_h a
dziphurodzheke	dz i p_h u r O dz h\ E k_> E
dzipmb	d z i p_> i E m b i
dziposo	dz i p_> O s O
dziredzhisitara	dz i r E dz h\ i s i t_> a r a
dziredzhisiṱara	dz i r E dz h\ i s i t_> a r a
dzirekhodo	dz i r E k_h O d_0Z O
dzisakhisheni	dz i s a k_h i S E n i
dzisamonisi	dz i s a m O n i s i
dzisenthara	dz i s E n t_h a r a
dzisesheni	dz i s E S E n i
dziseta	dz i s E t_> a
dzishere	dz i S E r E
dzisisiteme	dz i s i s i t_> E m E
dzismme	dz i s m E
dzithaidzo	dz i t_h a i dz O
dzithandela	dz i t_h a n d E l a
dzithanga	dz i t_h a n g a
dzithanzi	dz i t_h a n z i
dzithavha	dz i t_h a B a
dzithekhisi	dz i t_h E k_h i s i
dzithendara	dz i t_h E n d a r a
dzithikhithi	dz i t_h i k_h i t_h i
dzithodisiso	dz i t_h O d_0Z i s i s O
dzithoho	dz i t_h O h\ O
dzithophi	dz i t_h O p_h i
dzithundu	dz i t_h u n d u
dzithunzi	dz i t_h u n z i
dzithutha	dz i t_h u t_h a
dzitikedzaho	dz i t_> i k_> E dz a h\ O
dzitshaka	dz i tS_h a k_> a
dzitshakatshaka	dz i tS_h a k_> a tS_h a k_> a
dzitshakha	dz i tS_h a k_h a
dzitshakhatshakha	dz i tS_h a k_h a tS_h a k_h a
dzitshavhi	dz i tS_h a B i
dzitshena	dz i tS_h E n a
dzitshomedzo	dz i tS_h O m E dz O
dzitshumelo	dz i tS_h u m E l O
dzitsumbedzo	dz i ts_> u m b E dz O
dziunivesithi	dz i u n i v E s i t_h i
dzivhani	dz i B a n i
dzivhela	dz i B E l a
dzivhise	dz i B i s E
dzivhuluwa	dz i B u l u w a
dzividio	dz i v i d_0Z i O
dziwe	dz i w E
dziwee	dz i w E E
dziwua	dz i w u a
dziyuniti	dz i j u n i t_> i
dziyunivesithi	dz i j u n i v E s i t_h i
dziyunivesiti	dz i j u n i v E s i t_> i
dziḓorobo	dz i d O r O b O
dziḓoroboni	dz i d O r O b O n i
dziṅangani	dz i n a n g a n i
dziṅwe	dz i n w E
dziṋwe	dz i n w E
dziṱhanzi	dz i t_h a n z i
dziṱhirakha	dz i t_h i r a k_h a
dziṱhoho	dz i t_h O h\ O
dzo	dz O
dzofha	dz O p\ a
dzohe	dz O h\ E
dzolokwe	dz O l O k_> w E
dzone	dz O n E
dzot	d z O t_> i
dzothe	dz O t_h E
dzoṱhe	dz O t_h E
dzudzanya	dz u dz a J a
dzudzanye	dz u dz a J E
dzudzanyiwa	dz u dz a J i w a
dzudzanyiwaho	dz u dz a J i w a h\ O
dzudzanywa	dz u dz a J w a
dzudzanywaho	dz u dz a J w a h\ O
dzudzunganyiwa	dz u dz u n g a J i w a
dzula	dz u l a
dzulaho	dz u l a h\ O
dzulani	dz u l a n i
dzule	dz u l E
dzulela	dz u l E l a
dzulele	dz u l E l E
dzuli	dz u l i
dzulisea	dz u l i s E a
dzuliwa	dz u l i w a
dzulo	dz u l O
dzulwa	dz u l w a
dzumba	dz u m b a
dzumbama	dz u m b a m a
dzumbi	dz u m b i
dzumbiwa	dz u m b i w a
dzumbulula	dz u m b u l u l a
dzundeni	dz u n d E n i
dzungudza	dz u n g u dz a
dzuvha	dz u B a
dzwaini	dz w a i n i
dzwala	dz w a l a
dzwalwa	dz w a l w a
e	i
ea	E a
eaho	E a h\ O
eana	E a n a
early	a l i
early	E a r l j
east	E a s t_>
east	i s t_h
eastern	E a s t_> E r n
eastern	i s t_h E n
economic	i k_h E n O m i k_h
economy	i k_h O n E m i
edana	E d_0Z a n a
edanaho	E d_0Z a n a h\ O
edela	E d_0Z E l a
edziasa	E dz i a s a
edzisa	E dz i s a
edzisani	E dz i s a n i
edzise	E dz i s E
edzisea	E dz i s E a
edzisela	E dz i s E l a
edzisele	E dz i s E l E
edziselea	E dz i s E l E a
edziselwe	E dz i s E l w E
edziswa	E dz i sw a
ee	E E
eekihironiki	E E k_> i h\ i r O n i k_> i
eidzi	E i dz i
eighteenth	E i g t_> E E n t_h
eighteenth	E t_h i n f
eighty	E i g t_h
eighty	E t_h i
ekana	E k_> a n a
ekedza	E k_> E dz a
ekedzaho	E k_> E dz a h\ O
ekedzwa	E k_> E dz w a
eki	E k_> i
el	E l
ela	E l a
elana	E l a n a
elanaho	E l a n a h\ O
elane	E l a n E
elani	E l a n i
elected	i l E k_h t_h E d
elekanya	E l E k_> a J a
elekanyani	E l E k_> a J a n i
elekihironiki	E l E k_> i h\ i r O n i k_> i
elekitironiki	E l E k_> i t_> i r O n i k_> i
elekitoriniki	E l E k_> i t_> O r i n i k_> i
elela	E l E l a
elelana	E l E l a n a
elele	E l E l E
elelwe	E l E l w E
eletshedza	E l E tS_h E dz a
eletshedzana	E l E tS_h E dz a n a
eletshedze	E l E tS_h E dz E
eletshedzwa	E l E tS_h E dz w a
elim	E l i m
elimi	E l i m i
elwa	E l w a
embasi	E m b a s i
embasini	E m b a s i n i
eme	E m E
emeḽi	E m E l i
emia	E m i a
empire	E m p_h a E r
empire	E m p_> i r E
emu	E m u
enda	E n d a
endedza	E n d E dz a
endedzwa	E n d E dz w a
ene	E n E
enea	E n E a
eneala	E n E a l a
eneo	E n E O
engedza	E n g E dz a
engedzadza	E n g E dz a dz a
engedzea	E n g E dz E a
engedzeaho	E n g E dz E a h\ O
engedzedza	E n g E dz E dz a
engedzedzea	E n g E dz E dz E a
engedzedzwa	E n g E dz E dz w a
engedzedzwaho	E n g E dz E dz w a h\ O
engedzelwa	E n g E dz E l w a
engedziwa	E n g E dz i w a
engedziwaho	E n g E dz i w a h\ O
engedzwa	E n g E dz w a
england	E n g l a n d
england	i N l E n d
english	E n g l i S
english	i N l i s
eni	E n i
entered	E n t_> E r E d_0Z
entered	E n t_h E d
enzhe	E n Z E
eo	E O
episcopal	E p_h E s k_h E p_h E l
era	E r a
era	E r E
erf	E r p\
esiṱere	E s i t_> E r E
eskom	E s k_> O m
established	E s t_> a b l i S E d_0Z
established	i s t_h a b l i s t_h
etd	E t_> d_0Z
etshedza	E tS_h E dz a
etshedzi	E tS_h E dz i
eu	E u
eu	i j u
europa	E u r O p_> a
europa	j O r O p_h E
europe	E u r O p_> E
europe	j O r E p_h
european	E u r O p_> E a n
european	j O r E p_h E n
evee	E v E E
ewa	E w a
ewaho	E w a h\ O
excise	E k_h s a z
eḓana	E d a n a
eḓanaho	E d a n a h\ O
eḓanyisa	E d a J i s a
eḓela	E d E l a
eṱhe	E t_h E
fa	f a
fact	f a k_h t_h
faedza	f a E dz a
faela	f a E l a
faho	f a h\ O
faili	f a i l i
faini	f a i n i
fainiwe	f a i n i w E
falo	f a l O
fana	f a n a
fanaho	f a n a h\ O
fandisa	f a n d i s a
fandom	f a n d E m
fandom	f a n d O m
fane	f a n E
faneala	f a n E a l a
fanela	f a n E l a
fanelaho	f a n E l a h\ O
fanelwa	f a n E l w a
fanga	f a n g a
fani	f a n i
faniho	f a n i h\ O
fantasy	f a n t_> a s j
fantasy	f a n t_h E s i
fanyisa	f a J i s a
fara	f a r a
farafara	f a r a f a r a
farafarwa	f a r a f a r w a
faraho	f a r a h\ O
farakanea	f a r a k_> a n E a
farana	f a r a n a
faranaho	f a r a n a h\ O
farane	f a r a n E
fare	f a r E
fare	f E r
farea	f a r E a
farekana	f a r E k_> a n a
farela	f a r E l a
farelana	f a r E l a n a
farelani	f a r E l a n i
farelela	f a r E l E l a
farelelwa	f a r E l E l w a
fareleni	f a r E l E n i
farelwa	f a r E l w a
farelwaho	f a r E l w a h\ O
farisa	f a r i s a
fariswa	f a r i sw a
fariwa	f a r i w a
fariwaho	f a r i w a h\ O
fariwe	f a r i w E
farwa	f a r w a
farwaho	f a r w a h\ O
farwe	f a r w E
fasiṱere	f a s i t_> E r E
fathers	f a d E z
fathers	f a t_h E r s
fauntheini	f a u n t_h E i n i
faṱwa	f a t_> w a
fe	E f i
fe	f E
february	f E b j O r i
february	f E b r O r i
february	f E b r u a r j
federal	f E d_0Z E r a l
federal	f E d E r E l
feedback	f i d b a k_h
feisi	f E i s i
fekisi	f E k_> i s i
fela	f E l a
felo	f E l O
fema	f E m a
festival	f E s t_h E v E l
festival	f E s t_> i v a l
fet	f E t_>
fha	p\ a
fhaa	p\ a a
fhahehwa	p\ a h\ E w a
fhahehwe	p\ a h\ E w E
fhala	p\ a l a
fhalala	p\ a l a l a
fhalalisa	p\ a l a l i s a
fhambana	p\ a m b a n a
fhambanaho	p\ a m b a n a h\ O
fhambananaho	p\ a m b a n a n a h\ O
fhambanani	p\ a m b a n a n i
fhambane	p\ a m b a n E
fhambanela	p\ a m b a n E l a
fhambanesa	p\ a m b a n E s a
fhambanho	p\ a m b a n O
fhambani	p\ a m b a n i
fhambanya	p\ a m b a J a
fhambanyisa	p\ a m b a J i s a
fhane	p\ a n E
fhano	p\ a n O
fhasi	p\ a s i
fhasifhasi	p\ a s i p\ a s i
fhasisa	p\ a s i s a
fhata	p\ a t_> a
fhate	p\ a t_> E
fhatiwa	p\ a t_> i w a
fhatiwe	p\ a t_> i w E
fhaḓa	p\ a d a
fhaḽa	p\ a l a
fhaṱa	p\ a t_> a
fhaṱaho	p\ a t_> a h\ O
fhaṱela	p\ a t_> E l a
fhaṱelwa	p\ a t_> E l w a
fhaṱha	p\ a t_h a
fhaṱiho	p\ a t_> i h\ O
fhaṱwa	p\ a t_> w a
fhaṱwaho	p\ a t_> w a h\ O
fhe	p\ E
fhedza	p\ E dz a
fhedzaho	p\ E dz a h\ O
fhedze	p\ E dz E
fhedzi	p\ E dz i
fhedziha	p\ E dz i h\ a
fhedzisa	p\ E dz i s a
fhedzisela	p\ E dz i s E l a
fhefheiswa	p\ E p\ E i sw a
fhela	p\ E l a
fhelaho	p\ E l a h\ O
fhelekedza	p\ E l E k_> E dz a
fhelekedze	p\ E l E k_> E dz E
fhelekedzwa	p\ E l E k_> E dz w a
fhelela	p\ E l E l a
fhelelaho	p\ E l E l a h\ O
fheleledza	p\ E l E l E dz a
fhelelwa	p\ E l E l w a
fhelelwaho	p\ E l E l w a h\ O
fheli	p\ E l i
fhelisa	p\ E l i s a
fhelisiwa	p\ E l i s i w a
fheliswa	p\ E l i sw a
fhembeledza	p\ E m b E l E dz a
fhenya	p\ E J a
fhenywa	p\ E J w a
fhethu	p\ E t_h u
fhethuvhupo	p\ E t_h u B u p_> O
fheṱa	p\ E t_> a
fhidza	p\ i dz a
fhidzi	p\ i dz i
fhindula	p\ i n d u l a
fhindule	p\ i n d u l E
fhindulela	p\ i n d u l E l a
fhindulwa	p\ i n d u l w a
fhindulwaho	p\ i n d u l w a h\ O
fhindulwe	p\ i n d u l w E
fhira	p\ i r a
fhiraho	p\ i r a h\ O
fhirela	p\ i r E l a
fhirelaho	p\ i r E l a h\ O
fhiri	p\ i r i
fhiriho	p\ i r i h\ O
fhirisa	p\ i r i s a
fhirisaho	p\ i r i s a h\ O
fhirisela	p\ i r i s E l a
fhiriselani	p\ i r i s E l a n i
fhiriselwa	p\ i r i s E l w a
fhiriselwi	p\ i r i s E l w i
fhiriswa	p\ i r i sw a
fhirsisa	p\ i r s i s a
fhisa	p\ i s a
fhisaho	p\ i s a h\ O
fhisea	p\ i s E a
fhisesa	p\ i s E s a
fhiswa	p\ i sw a
fhiwa	p\ i w a
fhiwaho	p\ i w a h\ O
fhiwe	p\ i w E
fhodza	p\ O dz a
fhole	p\ O l E
fholisa	p\ O l i s a
fhufha	p\ u p\ a
fhufhela	p\ u p\ E l a
fhufhiswa	p\ u p\ i sw a
fhulufhedzea	p\ u l u p\ E dz E a
fhulufhelana	p\ u l u p\ E l a n a
fhulufhelo	p\ u l u p\ E l O
fhungo	p\ u n g O
fhungoni	p\ u n g O n i
fhungudza	p\ u n g u dz a
fhungudze	p\ u n g u dz E
fhungudzea	p\ u n g u dz E a
fhungudziwa	p\ u n g u dz i w a
fhungudzwa	p\ u n g u dz w a
fhura	p\ u r a
fhuri	p\ u r i
fhuriwa	p\ u r i w a
fiction	f i k_h s E n
field	f i E l d_0Z
field	f i l d
fifa	f i f a
figara	f i g a r a
filimu	f i l i m u
filing	f a l i N
filing	f i l i n g
film	f E l m
film	f i l m
films	f E l m z
films	f i l m s
fiḽimu	f i l i m u
flight	f l a t_h
flight	p\ l i g t_>
fo	f O
fogisi	f O g i s i
foinela	f O i n E l a
fola	f O l a
following	f O l l O w i n g
following	f O l O i N
folovhoḓwe	f O l O B O d w E
foma	f O m a
fomala	f O m a l a
fomathi	f O m a t_h i
fomla	f O m l a
fomo	f O m O
fomuḽa	f O m u l a
football	f O O t_> b a l l
football	f u t_h b O l
foramu	f O r a m u
force	f O s
forces	f O s E s
ford	f O d
ford	f O r d_0Z
foreign	f O r E i g n
foreign	f O r E n
forensikhi	f O r E n s i k_h i
form	f O m
form	f O r m
formulary	f O r m u l a r j
forward	f O r w a r d_0Z
forward	f O w E d
fothokhopha	f O t_h O k_h O p_h a
founele	f O u n E l E
founu	f O u n u
fovhela	f O B E l a
fovu	f O v u
francis	f r a n s E s
franklin	f r a N k_h l E n
franklin	p\ r a n k_> l i n
free	f r i
free	p\ r E E
freedom	f r i d E m
freedom	p\ r E E d_0Z O m
french	f r E n tS_h
frika	p\ r i k_> a
fuka	f u k_> a
fukwa	f u k_> w a
fula	f u l a
fulaga	f u l a g a
fule	f u l E
fulela	f u l E l a
fulo	f u l O
fuloraidi	f u l O r a i d_0Z i
fulu	f u l u
fulubo	f u l u b O
fulufhedzea	f u l u p\ E dz E a
fulufhedzeaho	f u l u p\ E dz E a h\ O
fulufhedzee	f u l u p\ E dz E E
fulufhedzisa	f u l u p\ E dz i s a
fulufhedzisaho	f u l u p\ E dz i s a h\ O
fulufhedziswa	f u l u p\ E dz i sw a
fulufhela	f u l u p\ E l a
fulufhelo	f u l u p\ E l O
fulufhelwa	f u l u p\ E l w a
fulufhuwa	f u l u p\ u w a
fulufulu	f u l u f u l u
fulwa	f u l w a
fulwana	f u l w a n a
fumbili	f u m b i l i
fumbilimbili	f u m b i l i m b i l i
fumi	f u m i
fumirathi	f u m i r a t_h i
fumiṱhanu	f u m i t_h a n u
funa	f u n a
funana	f u n a n a
function	f a N k_h s E n
fund	f a n d
fund	f u n d
fundamental	f a n d E m E n t_h E l
fundamental	f u n d a m E n t_> a l
funesa	f u n E s a
funeswaho	f u n E sw a h\ O
funga	f u n g a
fungiwa	f u n g i w a
fungiwe	f u n g i w E
funi	f u n i
funwa	f u n w a
funza	f u n z a
funzani	f u n z a n i
funzeaho	f u n z E a h\ O
funzedzela	f u n z E dz E l a
funzwa	f u n zw a
fura	f u r a
furalela	f u r a l E l a
furaru	f u r a r u
fureimiweke	f u r E i m i w E k_> E
fureisi	f u r E i s i
furemiweke	f u r E m i w E k_> E
furemiwekhe	f u r E m i w E k_h E
fureshe	f u r E S E
furu	f u r u
fusha	f u S a
fushaho	f u S a h\ O
fushea	f u S E a
fushi	f u S i
fushiho	f u S i h\ O
fushwa	f u S w a
fusumbe	f u s u m b E
futelela	f u t_> E l E l a
fuvhalo	f u B a l O
fuwa	f u w a
g	d_0Z i
ga	g a
gadze	g a dz E
gagamise	g a g a m i s E
gaganyelwa	g a g a J E l w a
gaganywa	g a g a J w a
gagaḓela	g a g a d E l a
gaidi	g a i d_0Z i
gala	g a l a
gala	g a l E
galatshela	g a l a tS_h E l a
gama	g a m a
game	g a m E
game	g E m
gamiwa	g a m i w a
gammba	g a m b a
gan	g a n
ganama	g a n a m a
gandisa	g a n d i s a
gandiswa	g a n d i sw a
gandiswaho	g a n d i sw a h\ O
ganiswa	g a n i sw a
ganḓiswa	g a n d i sw a
ganḓiswaho	g a n d i sw a h\ O
garaba	g a r a b a
garata	g a r a t_> a
garatshi	g a r a tS_h i
garaṱa	g a r a t_> a
gathi	g a t_h i
gaweni	g a w E n i
gazete	g a z E t_> E
gazethe	g a z E t_h E
gazette	g a z E t_> t_> E
gazette	g E z E t_h
gdp	d_0Z i d i p_h i
gdp	g d_0Z p_>
gebisi	g E b i s i
gekhana	g E k_h a n a
gems	d_0Z m z
gems	g E m s
gene	d_0Z i n
gene	g E n E
general	d_0Z E n r E l
general	g E n E r a l
geologist	d_0Z E O l E d_0Z E s t_h
geologist	g E O l O g i s t_>
george	d_0Z O d_0Z
george	g E O r g E
german	d_0Z a m E n
german	g E r m a n
germanic	d_0Z E m a n i k_h
gese	g E s E
gethe	g E t_h E
getheni	g E t_h E n i
gidima	g i d_0Z i m a
gidimisa	g i d_0Z i m i s a
girama	g i r a m a
giranthi	g i r a n t_h i
giratshini	g i r a tS_h i n i
givhieaho	g i B i E a h\ O
globe	g l O b
globe	g l O b E
goba	g O b a
gobela	g O b E l a
gobelela	g O b E l E l a
gobelele	g O b E l E l E
gobelelwaho	g O b E l E l w a h\ O
godoni	g O d_0Z O n i
gogo	g O g O
gogogo	g O g O g O
gogona	g O g O n a
gokoko	g O k_> O k_> O
golden	g O l d_0Z E n
golden	g O l d E n
goloi	g O l O i
goloini	g O l O i n i
gombo	g O m b O
gomelelo	g O m E l E l O
gondo	g O n d O
gondoni	g O n d O n i
goni	g O n i
gonitshedza	g O n i tS_h E dz a
gonobva	g O n O b v a
gonya	g O J a
gonyela	g O J E l a
gonyisela	g O J i s E l a
gonyiswa	g O J i sw a
goo	g O O
goo	g u
goosen	g O O s E n
goswi	g O sw i
gota	g O t_> a
gotsha	g O tS_h a
gotshiwa	g O tS_h i w a
goukou	g O u k_> O u
govha	g O B a
govho	g O B O
gpg	d_0Z i p_h i d_0Z i
graham	g r a h\ a m
graham	g r E h\ a m
grand	g r a n d
graphical	g r a f i k_h E l
great	g r E a t_>
great	g r E t_h
greek	g r E E k_>
greek	g r i k_h
green	g r E E n
green	g r i n
gu	g u
guda	g u d_0Z a
gudafhi	g u d_0Z a p\ i
gudaho	g u d_0Z a h\ O
gudazwithu	g u d_0Z a zw i t_h u
gude	g u d_0Z E
gudedzi	g u d_0Z E dz i
gudela	g u d_0Z E l a
gudelaho	g u d_0Z E l a h\ O
gudisa	g u d_0Z i s a
gudisiwaho	g u d_0Z i s i w a h\ O
gudiswa	g u d_0Z i sw a
gudiwa	g u d_0Z i w a
gudo	g u d_0Z O
gulu	g u l u
guma	g u m a
gumbu	g u m b u
gumi	g u m i
gungula	g u n g u l a
gunwe	g u n w E
gurannda	g u r a n n d a
gurannḓa	g u r a n n d a
guvhangano	g u B a n g a n O
guyuni	g u j u n i
guṱe	g u t_> E
gwa	g w a
gwalaba	g w a l a b a
gwama	g w a m a
gwangwangwani	g w a n g w a n g w a n i
gwara	g w a r a
gwati	g w a t_> i
gwaḓi	g w a d i
gwela	g w E l a
gwevha	g w E B a
gwevheliwa	g w E B E l i w a
gwevhiwa	g w E B i w a
gwisa	g w i s a
gwiwa	g w i w a
h	E tS_h
ha	h\ a
habegwa	h\ a b E g w a
hada	h\ a d_0Z a
hadiwee	h\ a d_0Z i w E E
hadzimiswa	h\ a dz i m i sw a
hadzinga	h\ a dz i n g a
hadzo	h\ a dz O
hadzwo	h\ a dz w O
hae	h\ a E
hafha	h\ a p\ a
hafhaḽa	h\ a p\ a l a
hafho	h\ a p\ O
hafhu	h\ a p\ u
hafu	h\ a f u
hahelelo	h\ a h\ E l E l O
hai	h\ a i
hall	h\ a l l
hall	h\ O l
halushaka	h\ a l u S a k_> a
halutshedzo	h\ a l u tS_h E dz O
halwa	h\ a l w a
hamiwa	h\ a m i w a
hamukula	h\ a m u k_> u l a
hamule	h\ a m u l E
hana	h\ a n a
hanaho	h\ a n a h\ O
hanedza	h\ a n E dz a
hanedzaho	h\ a n E dz a h\ O
hanedzana	h\ a n E dz a n a
hanedzeiho	h\ a n E dz E i h\ O
hanefha	h\ a n E p\ a
hanefho	h\ a n E p\ O
hanela	h\ a n E l a
hanelelwa	h\ a n E l E l w a
hanelwa	h\ a n E l w a
hanga	h\ a n g a
hanganea	h\ a n g a n E a
hangei	h\ a n g E i
hangenalano	h\ a n g E n a l a n O
hangoya	h\ a n g O j a
hangwa	h\ a n g w a
hangwe	h\ a n g w E
hangweliwa	h\ a n g w E l i w a
hani	h\ a n i
haniwa	h\ a n i w a
hanu	h\ a n u
hanya	h\ a J a
hanziela	h\ a n z i E l a
hao	h\ a O
hapo	h\ a p_> O
haramudza	h\ a r a m u dz a
hard	h\ a d
hard	h\ a r d_0Z
harry	h\ a r i
harry	h\ a r r j
hasan	h\ a s a n
hasan	h\ E z E n
hashu	h\ a S u
hasinthumule	h\ a s i n t_h u m u l E
hatha	h\ a t_h a
hatsho	h\ a tS_h O
hatsi	h\ a ts_> i
hatula	h\ a t_> u l a
hau	h\ a u
havha	h\ a B a
havhaḽa	h\ a B a l a
havhele	h\ a B E l E
havho	h\ a B O
havhoiyi	h\ a B O i j i
havhu	h\ a B u
havhudi	h\ a B u d_0Z i
havhui	h\ a B u i
havhuḓi	h\ a B u d i
hawe	h\ a w E
hawo	h\ a w O
haya	h\ a j a
hayani	h\ a j a n i
hayo	h\ a j O
hazwo	h\ a zw O
haṋu	h\ a n u
he	h\ E
he	h\ i
hedzi	h\ E dz i
hee	h\ E E
hei	h\ E i
hekhithara	h\ E k_h i t_h a r a
heliho	h\ E l i h\ O
henefha	h\ E n E p\ a
henefho	h\ E n E p\ O
henengei	h\ E n E n g E i
heritage	h\ E r E t_h i d_0Z
heritage	h\ E r i t_> a g E
heroine	h\ E r O E n
heroine	h\ E r O i n E
hetshi	h\ E tS_h i
hetshiḽa	h\ E tS_h i l a
hetsho	h\ E tS_h O
heyi	h\ E j i
hezwi	h\ E zw i
hezwio	h\ E zw i O
hezwo	h\ E zw O
heḽi	h\ E l i
heḽo	h\ E l O
high	h\ a
high	h\ i g
hingo	h\ i n g O
hira	h\ i r a
hiraingele	h\ i r a i n g E l E
hironiki	h\ i r O n i k_> i
historic	h\ i s t_h O r i k_h
history	h\ i s t_h r i
history	h\ i s t_> O r j
hiswa	h\ i sw a
hiv	h\ i B
ho	h\ O
hockey	h\ O k_h i
hod	h\ E d
hod	h\ O d_0Z
hoda	h\ O d_0Z a
hodea	h\ O d_0Z E a
hodelani	h\ O d_0Z E l a n i
hoea	h\ O E a
hogo	h\ O g O
hogwa	h\ O g w a
hohe	h\ O h\ E
hoho	h\ O h\ O
hohu	h\ O h\ u
hoisiso	h\ O i s i s O
hoku	h\ O k_> u
hola	h\ O l a
holefhala	h\ O l E p\ a l a
holela	h\ O l E l a
holo	h\ O l O
holodeni	h\ O l O d_0Z E n i
holu	h\ O l u
holwu	h\ O l w u
hombo	h\ O m b O
hombokiwa	h\ O m b O k_> i w a
home	h\ O m
home	h\ O m E
hona	h\ O n a
hone	h\ O n
hone	h\ O n E
honeha	h\ O n E a
honifhiwa	h\ O n i p\ i w a
honoho	h\ O n O h\ O
honovhu	h\ O n O B u
hoo	h\ O O
hoo	h\ u
horizontal	h\ O r i z O n t_> a l
horizontal	h\ O r i z O n t_h E l
hot	h\ O t_>
hot	h\ O t_h
hothe	h\ O t_h E
hotshatsha	h\ O tS_h a tS_h a
houla	h\ O u l a
hovha	h\ O B a
hovhelelaho	h\ O B E l E l a h\ O
hovhu	h\ O B u
howa	h\ O w a
hoyo	h\ O j O
hoyu	h\ O j u
hoṱhe	h\ O t_h E
hu	h\ u
huatakadza	h\ u a t_> a k_> a dz a
hub	h\ a b
hub	h\ u b
hudza	h\ u dz a
hudzaho	h\ u dz a h\ O
huhulu	h\ u h\ u l u
huhuwedzo	h\ u h\ u w E dz O
hukhu	h\ u k_h u
hula	h\ a u l E
hula	h\ u l a
hulaho	h\ u l a h\ O
hulela	h\ u l E l a
hulisa	h\ u l i s a
hulwane	h\ u l w a n E
huma	h\ u m a
human	h\ j u m E n
human	h\ u m a n
human	j u m E n
humbela	h\ u m b E l a
humbele	h\ u m b E l E
humbelwa	h\ u m b E l w a
humbelwaho	h\ u m b E l w a h\ O
humbelwi	h\ u m b E l w i
humbudza	h\ u m b u dz a
humbula	h\ u m b u l a
humbule	h\ u m b u l E
humbulela	h\ u m b u l E l a
humbulelavho	h\ u m b u l E l a B O
humbulelwa	h\ u m b u l E l w a
humbulisa	h\ u m b u l i s a
humela	h\ u m E l a
humelani	h\ u m E l a n i
humisa	h\ u m i s a
humisea	h\ u m i s E a
humisela	h\ u m i s E l a
humiselwa	h\ u m i s E l w a
humiswa	h\ u m i sw a
humusilwe	h\ u m u s i l w E
huna	h\ u n a
hune	h\ u n E
huneya	h\ u n E j a
hunga	h\ u n g a
hungu	h\ u n g u
hungulula	h\ u n g u l u l a
huno	h\ u n O
hunwe	h\ u n w E
hunzhi	h\ u n Z i
husimamilayo	h\ u s i m a m i l a j O
huswa	h\ u sw a
hut	h\ a t_h
hut	h\ u t_>
huthihi	h\ u t_h i h\ i
hutshi	h\ u tS_h i
huvha	h\ u B a
huvhala	h\ u B a l a
huvhalaho	h\ u B a l a h\ O
huvhale	h\ u B a l E
huvhe	h\ u B E
huwe	h\ u w E
huwedzo	h\ u w E dz O
huṅwe	h\ u n w E
huṋwe	h\ u n w E
huṱuku	h\ u t_> u k_> u
hwa	h\ w a
hwala	h\ w a l a
hwalaho	h\ w a l a h\ O
hwalana	h\ w a l a n a
hwalesaho	h\ w a l E s a h\ O
hwalisana	h\ w a l i s a n a
hwalwa	h\ w a l w a
hwedza	h\ w E dz a
hwelelwa	h\ w E l E l w a
hwelelwaho	h\ w E l E l w a h\ O
hwelwaho	h\ w E l w a h\ O
hwenya	h\ w E J a
hwenyela	h\ w E J E l a
hweswaho	h\ w E sw a h\ O
hweswe	h\ w E sw E
i	a
iani	i a n i
ibinizimu	i b i n i z i m u
icasa	a k_h E z E
icd	a k_h d
id	i d
id	i d_0Z
idd	i d_0Z d_0Z
idp	i d_0Z p_>
idt	i d_0Z t_>
idzanu	i dz a n u
idzhenisa	i dz h\ E n i s a
idzi	i dz i
idzo	i dz O
idzwo	i dz w O
ie	i
ie	i E
ieti	i E t_> i
ifa	i f a
ifara	i f a r a
ifarafara	i f a r a f a r a
ifha	i p\ a
ifhasi	i p\ a s i
ifhedzi	i p\ E dz i
ifhinduleli	i p\ i n d u l E l i
ifhio	i p\ i O
ifulufhela	i f u l u p\ E l a
ihulwane	i h\ u l w a n E
ii	a a
ii	i i
iii	a a a
iii	i i i
iimisaho	i i m i s a h\ O
iimisela	i i m i s E l a
iingwa	i i n g w a
iitela	i i t_> E l a
ik	i k_>
ikhomese	i k_h O m E s E
iki	i k_> i
ikomoni	i k_> O m O n i
ikonomi	i k_> O n O m i
iks	i k_> s
ikukumusa	i k_> u k_> u m u s a
ikukumuse	i k_> u k_> u m u s E
ikumbedzwa	i k_> u m b E dz w a
ila	i l a
ilafha	i l a p\ a
iledzwa	i l E dz w a
iledzwaho	i l E dz w a h\ O
ili	i l i
ilo	i l O
ilugisela	i l u g i s E l a
ima	i m a
imaga	i m a g a
imaho	i m a h\ O
iman	i m a n
imanyana	i m a J a n a
imba	i m b a
imbelwa	i m b E l w a
imbiwa	i m b i w a
ime	i m E
imedzana	i m E dz a n a
imela	i m E l a
imelaho	i m E l a h\ O
imelela	i m E l E l a
imelelwa	i m E l E l w a
imelwa	i m E l w a
imf	a E m E f
imf	i m p\
imi	i m i
imisa	i m i s a
imise	i m i s E
imisela	i m i s E l a
imisiwa	i m i s i w a
imiswa	i m i sw a
imiswe	i m i sw E
imperial	i m p_> E r i a l
imperial	i m p_h E r E l
imvumusa	i m v u m u s a
imvumvusa	i m v u m v u s a
ina	i n a
indas	i n d a s
indasi	i n d a s i
indasiteri	i n d a s i t_> E r i
indasiṱeri	i n d a s i t_> E r i
indasiṱiri	i n d a s i t_> i r i
independent	i n d E p_> E n d E n t_>
independent	i n d i p_h E n d E n t_h
index	i n d E k_h s
index	i n d E x
india	i n d E
india	i n d i a
indies	i n d i E s
indies	i n d i z
ine	i n E
inekedzela	i n E k_> E dz E l a
inetisela	i n E t_> i s E l a
infant	i n f a n t_>
infant	i n f E n t_h
infomesheni	i n f O m E S E n i
inga	i n g a
ingamela	i n g a m E l a
ingiwaho	i n g i w a h\ O
ingwa	i n g w a
inifulesheni	i n i f u l E S E n i
inikhiripushini	i n i k_h i r i p_> u S i n i
inkatha	i n k_> a t_h a
inkatha	i N k_h E f a
ino	i n O
integrated	i n t_> E g r a t_> E d_0Z
integrated	i n t_h i g r E t_h E d
intellectual	i n t_h E l E k_h tS_h O l
interface	i n t_h E f E s
interim	i n t_> E r i m
interim	i n t_h E r E m
international	i n t_> E r n a t_> i O n a l
international	i n t_h E n a s E n E l
internet	i n t_> E r n E t_>
internet	i n t_h E r n E t_h
inthanethe	i n t_h a n E t_h E
inthaseputha	i n t_h a s E p_> u t_h a
inthaviwu	i n t_h a v i w u
investment	i n v E s t_h m E n t_h
investment	i n v E s t_> m E n t_>
invoice	i n v O s
inwalisa	i n w a l i s a
inwe	i n w E
inwi	i n w i
inwia	i n w i a
inzhinere	i n Z i n E r E
io	i O
ip	a p_h i
ip	i p_>
ipfi	i p_> f i
ira	i r a
irafuthi	i r a f u t_h i
irakisi	i r a k_> i s i
irama	i r a m a
iran	i r a n
iraq	i r a k_h
ire	i r
ire	i r E
iri	i r i
irish	a r i s
irish	i r i S
iron	a E n
iron	i r O n
irouku	i r O u k_> u
irwa	i r w a
isa	i s a
isaho	i s a h\ O
isana	i s a n a
isaniwa	i s a n i w a
isano	i s a n O
ise	i s E
isedzi	i s E dz i
isedzwa	i s E dz w a
iselwa	i s E l w a
isendeka	i s E n d E k_> a
isi	i s i
isiraele	i s i r a E l E
isisa	i s i s a
isiso	i s i s O
islamic	i z l a m i k_h
island	a l E n d
island	i s l a n d
iss	i s s
isumbedza	i s u m b E dz a
iswa	i sw a
iswe	i sw E
ita	i t_> a
itaho	i t_> a h\ O
italy	i t_> a l j
italy	i t_h E l i
itani	i t_> a n i
itauri	i t_> a u r i
ite	i t_> E
itea	i t_> E a
iteaho	i t_> E a h\ O
itela	i t_> E l a
iteli	i t_> E l i
itelwa	i t_> E l w a
itelwaho	i t_> E l w a h\ O
itelwavho	i t_> E l w a B O
itelwe	i t_> E l w E
ithihi	i t_h i h\ i
iti	i t_> i
itikaho	i t_> i k_> a h\ O
itisaho	i t_> i s a h\ O
itiswa	i t_> i sw a
itiswaho	i t_> i sw a h\ O
itiwa	i t_> i w a
itiwaho	i t_> i w a h\ O
itiwe	i t_> i w E
itopia	i t_> O p_> i a
itsani	i ts_> a n i
itshena	i tS_h E n a
itshi	i tS_h i
itsho	i tS_h O
itwa	i t_> w a
itwaho	i t_> w a h\ O
itwe	i t_> w E
iu	i u
iuingo	i u i n g O
iv	i B
ivha	i B a
ivhadza	i B a dz a
ivhadzwa	i B a dz w a
ivhani	i B a n i
ivhazwakale	i B a zw a k_> a l E
ivhe	i B E
ivho	i B O
ivhonetshela	i B O n E tS_h E l a
ivhudzisi	i B u dz i s i
ivhulaha	i B u l a h\ a
iwa	i w a
iwalo	i w a l O
iwalwa	i w a l w a
iwe	i w E
iya	i j a
iyi	i j i
iyo	i j O
izi	i z i
izwi	i zw i
izwo	i zw O
iḓa	i d a
iḽa	i l a
iḽi	i l i
iḽla	i l l a
iḽo	i l O
iṅwe	i n w E
iṋe	i n E
iṋwe	i n w E
iṱali	i t_> a l i
iṱeli	i t_> E l i
iṱo	i t_> O
japanese	d_0Z a p_h E n i z
jewish	d_0Z u w i s
july	d_0Z u l a
june	d_0Z u n
ka	k_> a
kaidza	k_> a i dz a
kaini	k_> a i n i
kakata	k_> a k_> a t_> a
kakatana	k_> a k_> a t_> a n a
kala	k_> a l a
kalala	k_> a l a l a
kale	k_> a l E
kale	k_h E l
kalekale	k_> a l E k_> a l E
kaliwa	k_> a l i w a
kalulaho	k_> a l u l a h\ O
kamara	k_> a m a r a
kambiwa	k_> a m b i w a
kana	k_> a n a
kanarakhemisi	k_> a n a r a k_h E m i s i
kanda	k_> a n d a
kande	k_> a n d E
kandekanya	k_> a n d E k_> a J a
kandeledza	k_> a n d E l E dz a
kandisa	k_> a n d i s a
kandise	k_> a n d i s E
kandiswa	k_> a n d i sw a
kandiwa	k_> a n d i w a
kanga	k_> a n g a
kanganyisa	k_> a n g a J i s a
kanganyisea	k_> a n g a J i s E a
kanganyiswa	k_> a n g a J i sw a
kani	k_> a n i
kansas	k_> a n s a s
kansas	k_h a n z E s
kanya	k_> a J a
kanzhi	k_> a n Z i
kanzhisa	k_> a n Z i s a
kapa	k_> a p_> a
kapu	k_> a p_> u
kata	k_> a t_> a
katela	k_> a t_> E l a
katelaho	k_> a t_> E l a h\ O
katele	k_> a t_> E l E
kateli	k_> a t_> E l i
katelwa	k_> a t_> E l w a
katelwaho	k_> a t_> E l w a h\ O
katelwe	k_> a t_> E l w E
katelwi	k_> a t_> E l w i
kathihi	k_> a t_h i h\ i
kati	k_> a t_> i
kavha	k_> a B a
kavhili	k_> a B i l i
kavhiwa	k_> a B i w a
kavhiwe	k_> a B i w E
kaṋa	k_> a n a
kegula	k_> E g u l a
kereke	k_> E r E k_> E
kha	k_h a
khabinete	k_h a b i n E t_> E
khabinethe	k_h a b i n E t_h E
khaboni	k_h a b O n i
khabonimokosaidi	k_h a b O n i m O k_> O s a i d_0Z i
khada	k_h a d_0Z a
khadi	k_h a d_0Z i
khadonngi	k_h a d_0Z O n n g i
khadzimiso	k_h a dz i m i s O
khadzo	k_h a dz O
khae	k_h a E
khaedu	k_h a E d_0Z u
khagala	k_h a g a l a
khaho	k_h a h\ O
khahulo	k_h a h\ u l O
khaidzo	k_h a i dz O
khaithi	k_h a i t_h i
khakha	k_h a k_h a
khakhaho	k_h a k_h a h\ O
khakhathi	k_h a k_h a t_h i
khakhea	k_h a k_h E a
khakheaho	k_h a k_h E a h\ O
khakhelaho	k_h a k_h E l a h\ O
khakhisa	k_h a k_h i s a
khakhisee	k_h a k_h i s E E
khakhisi	k_h a k_h i s i
khakhiswa	k_h a k_h i sw a
khakhu	k_h a k_h u
khakhulula	k_h a k_h u l u l a
khakhululo	k_h a k_h u l u l O
khakwo	k_h a k_> w O
khala	k_h a l a
khaladzi	k_h a l a dz i
khalavha	k_h a l a B a
khalaṅwaha	k_h a l a n w a h\ a
khalaṋwaha	k_h a l a n w a h\ a
khali	k_h a l i
khalo	k_h a l O
khampani	k_h a m p_> a n i
khamphani	k_h a m p_h a n i
khamusi	k_h a m u s i
khanabisi	k_h a n a b i s i
khanadzei	k_h a n a dz E i
khanani	k_h a n a n i
khanedzano	k_h a n E dz a n O
khani	k_h a n i
khantsela	k_h a n ts_> E l a
khantseliwa	k_h a n ts_> E l i w a
khao	k_h a O
khaphu	k_h a p_h u
khasho	k_h a S O
khasi	k_h a s i
khasiama	k_h a s i a m a
khasitama	k_h a s i t_> a m a
khasiṱama	k_h a s i t_> a m a
khathihi	k_h a t_h i h\ i
khathulo	k_h a t_h u l O
khathuwa	k_h a t_h u w a
khatsho	k_h a tS_h O
khau	k_h a u
khaulwa	k_h a u l w a
khaunthara	k_h a u n t_h a r a
khauthara	k_h a u t_h a r a
khavara	k_h a v a r a
khavariwa	k_h a v a r i w a
khavhishi	k_h a B i S i
khavho	k_h a B O
khavhomaṱamba	k_h a B O m a t_> a m b a
khawo	k_h a w O
khayo	k_h a j O
khazwo	k_h a zw O
khaḓa	k_h a d a
khaḽo	k_h a l O
khaṱhulo	k_h a t_h u l O
khaṱhululo	k_h a t_h u l u l O
khaṱulo	k_h a t_> u l O
khe	k_h E
khefini	k_h E f i n i
khei	k_h E i
kheiḽa	k_h E i l a
khemikhala	k_h E m i k_h a l a
khentsa	k_h E n ts_> a
kheri	k_h E r i
kheroti	k_h E r O t_> i
kherotsi	k_h E r O ts_> i
kheruwa	k_h E r u w a
kheshe	k_h E S E
khetha	k_h E t_h a
khethe	k_h E t_h E
khetheaho	k_h E t_h E a h\ O
khethekanyo	k_h E t_h E k_> a J O
khethekanywa	k_h E t_h E k_> a J w a
khetho	k_h E t_h O
khethulula	k_h E t_h u l u l a
khethululo	k_h E t_h u l u l O
khethululoe	k_h E t_h u l u l O E
khethululwa	k_h E t_h u l u l w a
khethwaho	k_h E t_h w a h\ O
khevha	k_h E B a
khezwi	k_h E zw i
khiridithi	k_h i r i d_0Z i t_h i
khirikhethe	k_h i r i k_h E t_h E
khishini	k_h i S i n i
khiya	k_h i j a
khiyi	k_h i j i
kho	k_h O
khofhe	k_h O p\ E
khohakhombo	k_h O h\ a k_h O m b O
khoisan	k_h O i s a n
khoisan	k_h O s a n
khokheini	k_h O k_h E i n i
khokhonya	k_h O k_h O J a
khole	k_h O l E
kholera	k_h O l E r a
kholishi	k_h O l i S i
kholomo	k_h O l O m O
kholoniala	k_h O l O n i a l a
khom	k_h O m
khomanda	k_h O m a n d a
khomba	k_h O m b a
khombe	k_h O m b E
khombekhombe	k_h O m b E k_h O m b E
khombo	k_h O m b O
khombole	k_h O m b O l E
khomboni	k_h O m b O n i
khomese	k_h O m E s E
khomishimi	k_h O m i S i m i
khomishinari	k_h O m i S i n a r i
khomishini	k_h O m i S i n i
khomphutha	k_h O m p_h u t_h a
khomphwutha	k_h O m p_h w u t_h a
khomputha	k_h O m p_> u t_h a
khona	k_h O n a
khonadzeo	k_h O n a dz E O
khonani	k_h O n a n i
khondomo	k_h O n d O m O
khonekhitha	k_h O n E k_h i t_h a
khonekhithiwaho	k_h O n E k_h i t_h i w a h\ O
khonekhithululwa	k_h O n E k_h i t_h u l u l w a
khonekhithululwe	k_h O n E k_h i t_h u l u l w E
khonferentsini	k_h O n f E r E n ts_> i n i
khoniferentsi	k_h O n i f E r E n ts_> i
khonisa	k_h O n i s a
khono	k_h O n O
khonthiraka	k_h O n t_h i r a k_> a
khophi	k_h O p_h i
khophorethivi	k_h O p_h O r E t_h i v i
khorale	k_h O r a l E
khoro	k_h O r O
khorombusi	k_h O r O m b u s i
khorondanguli	k_h O r O n d a n g u l i
khoroni	k_h O r O n i
khorotshitumbe	k_h O r O tS_h i t_> u m b E
khorwana	k_h O r w a n a
khosi	k_h O s i
khosimetiki	k_h O s i m E t_> i k_> i
khothe	k_h O t_h E
khothesheni	k_h O t_h E S E n i
khotho	k_h O t_h O
khothoni	k_h O t_h O n i
khotsi	k_h O ts_> i
khotsimunene	k_h O ts_> i m u n E n E
khou	k_h O u
khoudu	k_h O u d_0Z u
khouḽa	k_h O u l a
khovhe	k_h O B E
khovhekano	k_h O B E k_> a n O
khovhekanyo	k_h O B E k_> a J O
khoyu	k_h O j u
khoḓa	k_h O d a
khoḓedzela	k_h O d E dz E l a
khoḽera	k_h O l E r a
khoḽidzhi	k_h O l i dz h\ i
khu	k_h u
khubvi	k_h u b v i
khubvumedzi	k_h u b v u m E dz i
khud	k_h u d
khudano	k_h u d_0Z a n O
khuhu	k_h u h\ u
khuhulwane	k_h u h\ u l w a n E
khukhulisea	k_h u k_h u l i s E a
khula	k_h u l a
khuli	k_h u l i
khuliso	k_h u l i s O
khulu	k_h u l u
khulunoni	k_h u l u n O n i
khulwane	k_h u l w a n E
khumba	k_h u m b a
khumbelo	k_h u m b E l O
khundu	k_h u n d u
khungaho	k_h u n g a h\ O
khungedzelo	k_h u n g E dz E l O
khunguwedzelo	k_h u n g u w E dz E l O
khunguwedzo	k_h u n g u w E dz O
khuni	k_h u n i
khunyeledza	k_h u J E l E dz a
khunyeledzwa	k_h u J E l E dz w a
khunzikhunzini	k_h u n z i k_h u n z i n i
khuredzela	k_h u r E dz E l a
khuruanyi	k_h u r u a J i
khuthadza	k_h u t_h a dz a
khuvha	k_h u B a
khuvhalo	k_h u B a l O
khuvhangano	k_h u B a n g a n O
khuvhanganyo	k_h u B a n g a J O
khuvhuwa	k_h u B u w a
khuwelelo	k_h u w E l E l O
khuḓa	k_h u d a
khuḓani	k_h u d a n i
khuḓano	k_h u d a n O
khwa	k_h w a
khwahaho	k_h w a h\ a h\ O
khwahisa	k_h w a h\ i s a
khwahisedzo	k_h w a h\ i s E dz O
khwakhwa	k_h w a k_h w a
khwalithi	k_h w a l i t_h i
khwanda	k_h w a n d a
khwashe	k_h w a S E
khwathaho	k_h w a t_h a h\ O
khwathisa	k_h w a t_h i s a
khwathisedza	k_h w a t_h i s E dz a
khwathisedzo	k_h w a t_h i s E dz O
khwathisedzwa	k_h w a t_h i s E dz w a
khwathisedzwaho	k_h w a t_h i s E dz w a h\ O
khwathiswa	k_h w a t_h i sw a
khwaḽithi	k_h w a l i t_h i
khwaṱha	k_h w a t_h a
khwaṱhaho	k_h w a t_h a h\ O
khwaṱhisa	k_h w a t_h i s a
khwaṱhisaho	k_h w a t_h i s a h\ O
khwaṱhise	k_h w a t_h i s E
khwaṱhisedza	k_h w a t_h i s E dz a
khwaṱhisedzaho	k_h w a t_h i s E dz a h\ O
khwaṱhisedzo	k_h w a t_h i s E dz O
khwaṱhisedzwa	k_h w a t_h i s E dz w a
khwaṱhiswa	k_h w a t_h i sw a
khwese	k_h w E s E
khwine	k_h w i n E
khwinifhadza	k_h w i n i p\ a dz a
khwinifhadzea	k_h w i n i p\ a dz E a
khwinifhadzo	k_h w i n i p\ a dz O
khwinifhadzwa	k_h w i n i p\ a dz w a
khwinifhala	k_h w i n i p\ a l a
khwinisa	k_h w i n i s a
khwinisea	k_h w i n i s E a
khwiniseaho	k_h w i n i s E a h\ O
khwiniso	k_h w i n i s O
khwiniswa	k_h w i n i sw a
khwiniswaho	k_h w i n i sw a h\ O
khwiniswe	k_h w i n i sw E
khwiṋe	k_h w i n E
khwiṋisa	k_h w i n i s a
khwiṋiswa	k_h w i n i sw a
kilabu	k_> i l a b u
kilasini	k_> i l a s i n i
kilima	k_> i l i m a
kiliniki	k_> i l i n i k_> i
kilinikini	k_> i l i n i k_> i n i
king	k_h i N
king	k_> i n g
kiḽasi	k_> i l a s i
kiḽeima	k_> i l E i m a
kiḽeimi	k_> i l E i m i
kiḽiniki	k_> i l i n i k_> i
knights	k_> n i g ts_>
knights	n a t_h s
koe	k_> O E
kokodza	k_> O k_> O dz a
kokodzi	k_> O k_> O dz i
kokodziwiho	k_> O k_> O dz i w i h\ O
kokota	k_> O k_> O t_> a
kokotolo	k_> O k_> O t_> O l O
kokovha	k_> O k_> O B a
kolekiwaho	k_> O l E k_> i w a h\ O
kolelwa	k_> O l E l w a
koloda	k_> O l O d_0Z a
kolode	k_> O l O d_0Z E
kolodwaho	k_> O l O d w a h\ O
kombamulula	k_> O m b a m u l u l a
kombetshedza	k_> O m b E tS_h E dz a
kombetshedzei	k_> O m b E tS_h E dz E i
kombetshedzwa	k_> O m b E tS_h E dz w a
komiti	k_> O m i t_> i
komolela	k_> O m O l E l a
kon	k_> O n
kona	k_> O n a
konadzea	k_> O n a dz E a
konadzee	k_> O n a dz E E
konadzei	k_> O n a dz E i
konaho	k_> O n a h\ O
konana	k_> O n a n a
konanani	k_> O n a n a n i
konanya	k_> O n a J a
konau	k_> O n a u
konda	k_> O n d a
kondaho	k_> O n d a h\ O
kondelelana	k_> O n d E l E l a n a
kone	k_> O n E
konedzea	k_> O n E dz E a
konesa	k_> O n E s a
konevho	k_> O n E B O
koni	k_> O n i
konisa	k_> O n i s a
konou	k_> O n O u
kontiraka	k_> O n t_> i r a k_> a
konyolela	k_> O J O l E l a
konḓa	k_> O n d a
konḓela	k_> O n d E l a
konḓelela	k_> O n d E l E l a
konḓelele	k_> O n d E l E l E
konḓelelwa	k_> O n d E l E l w a
konḓelwa	k_> O n d E l w a
konḓi	k_> O n d i
konḓiho	k_> O n d i h\ O
konḓisa	k_> O n d i s a
konṱiraka	k_> O n t_> i r a k_> a
kope	k_> O p_> E
kopi	k_> O p_> i
kopiwaho	k_> O p_> i w a h\ O
kopololwa	k_> O p_> O l O l w a
koporasi	k_> O p_> O r a s i
korea	k_h E r E
korea	k_> O r E a
kotara	k_> O t_> a r a
kovha	k_> O B a
kovhana	k_> O B a n a
kovhekana	k_> O B E k_> a n a
kovhekane	k_> O B E k_> a n E
kovhekanya	k_> O B E k_> a J a
kovhekanyiwa	k_> O B E k_> a J i w a
kovhekanywa	k_> O B E k_> a J w a
kovhela	k_> O B E l a
kovhelwa	k_> O B E l w a
koḓa	k_> O d a
koḽeka	k_> O l E k_> a
ku	k_h u
ku	k_> u
kubadelele	k_> u b a d_0Z E l E l E
kubebelwe	k_> u b E b E l w E
kubugwana	k_> u b u g w a n a
kubulele	k_> u b u l E l E
kubulinyana	k_> u b u l i J a n a
kudalele	k_> u d_0Z a l E l E
kudani	k_> u d_0Z a n i
kudzhenele	k_> u dz h\ E n E l E
kufarele	k_> u f a r E l E
kufarelwe	k_> u f a r E l w E
kuitele	k_> u i t_> E l E
kukaladzi	k_> u k_> a l a dz i
kukumuwa	k_> u k_> u m u w a
kulangulele	k_> u l a n g u l E l E
kule	k_> u l E
kulea	k_> u l E a
kulidzele	k_> u l i dz E l E
kumalele	k_> u m a l E l E
kumbela	k_> u m b E l a
kumbululwa	k_> u m b u l u l w a
kumedza	k_> u m E dz a
kumedzela	k_> u m E dz E l a
kumedzwa	k_> u m E dz w a
kuna	k_> u n a
kunaho	k_> u n a h\ O
kunakisa	k_> u n a k_> i s a
kunambarele	k_> u n a m b a r E l E
kunamiswa	k_> u n a m i sw a
kunda	k_> u n d a
kundela	k_> u n d E l a
kundelwa	k_> u n d E l w a
kundelwaho	k_> u n d E l w a h\ O
kundisa	k_> u n d i s a
kundwa	k_> u n d w a
kune	k_> u n E
kunga	k_> u n g a
kungaho	k_> u n g a h\ O
kungedzelwaho	k_> u n g E dz E l w a h\ O
kungela	k_> u n g E l a
kungi	k_> u n g i
kungiwa	k_> u n g i w a
kunomborele	k_> u n O m b O r E l E
kunwalele	k_> u n w a l E l E
kunḓelwaho	k_> u n d E l w a h\ O
kupula	k_> u p_> u l a
kushemele	k_> u S E m E l E
kushumele	k_> u S u m E l E
kushumisele	k_> u S u m i s E l E
kusi	k_> u s i
kusikelwe	k_> u s i k_> E l w E
kuswa	k_> u sw a
kutama	k_> u t_> a m a
kutambele	k_> u t_> a m b E l E
kutevhekanele	k_> u t_> E B E k_> a n E l E
kutholele	k_> u t_h O l E l E
kutshilele	k_> u tS_h i l E l E
kutshimbidzele	k_> u tS_h i m b i dz E l E
kutshimbidzelwe	k_> u tS_h i m b i dz E l w E
kutukana	k_> u t_> u k_> a n a
kuvenḓa	k_> u v E n d a
kuvhangana	k_> u B a n g a n a
kuvhanganaho	k_> u B a n g a n a h\ O
kuvhanganya	k_> u B a n g a J a
kuvhanganyiwa	k_> u B a n g a J i w a
kuvhatedza	k_> u B a t_> E dz a
kuvhekaneyele	k_> u B E k_> a n E j E l E
kuvhonele	k_> u B O n E l E
kuvhulungelwe	k_> u B u l u n g E l w E
kuvhumbelwe	k_> u B u m b E l w E
kuvhunganywe	k_> u B u n g a J w E
kuvhusele	k_> u B u s E l E
kuwe	k_> u w E
kuḓana	k_> u d a n a
kuḓane	k_> u d a n E
kuḽele	k_> u l E l E
kuṅwalele	k_> u n w a l E l E
kuṱanganyisele	k_> u t_> a n g a J i s E l E
kwa	k_> w a
kwae	k_> w a E
kwakwana	k_> w a k_> w a n a
kwakwanya	k_> w a k_> w a J a
kwama	k_> w a m a
kwamaho	k_> w a m a h\ O
kwamana	k_> w a m a n a
kwamane	k_> w a m a n E
kwamanya	k_> w a m a J a
kwambatela	k_> w a m b a t_> E l a
kwame	k_> w a m E
kwamea	k_> w a m E a
kwameaho	k_> w a m E a h\ O
kwamee	k_> w a m E E
kwamei	k_> w a m E i
kwami	k_> w a m i
kwamiwa	k_> w a m i w a
kwanyeledza	k_> w a J E l E dz a
kwasha	k_> w a S a
kwashu	k_> w a S u
kwavho	k_> w a B O
kwavhui	k_> w a B u i
kwavhuḓi	k_> w a B u d i
kwawe	k_> w a w E
kwawo	k_> w a w O
kwayo	k_> w a j O
kwazulu	k_> w a z u l u
kwe	k_> w E
kwilidza	k_> w i l i dz a
kwo	k_> w O
kwone	k_> w O n E
kwonoku	k_> w O n O k_> u
kwoṱhe	k_> w O t_h E
kwu	k_> w u
l	a l
la	l a
labulu	l a b u l u
laden	l a d_0Z E n
laden	l E d E n
laedza	l a E dz a
laela	l a E l a
lafha	l a p\ a
lafhiwa	l a p\ i w a
lafhiwe	l a p\ i w E
laisentsi	l a i s E n ts_> i
lake	l a k_> E
lake	l E k_h
lala	l a l a
lambamai	l a m b a m a i
lambani	l a m b a n i
lambedza	l a m b E dz a
lambedzwa	l a m b E dz w a
lambedzwaho	l a m b E dz w a h\ O
lamukanya	l a m u k_> a J a
lamukisa	l a m u k_> i s a
lamula	l a m u l a
landula	l a n d u l a
langa	l a n g a
langana	l a n g a n a
langiwa	l a n g i w a
languages	l a n g u a g E s
languages	l a N g w i d_0Z E z
langula	l a n g u l a
langulaho	l a n g u l a h\ O
languli	l a n g u l i
langulwa	l a n g u l w a
langulwe	l a n g u l w E
langwa	l a n g w a
lanu	l a n u
lapfa	l a p_> f a
lapfesa	l a p_> f E s a
lapfiswa	l a p_> f i sw a
lara	l a r a
largest	l a d_0Z E s t_h
largest	l a r g E s t_>
late	l a t_> E
late	l E t_h
laula	l a u l a
laule	l a u l E
lauleli	l a u l E l i
laulwa	l a u l w a
laulwaho	l a u l w a h\ O
laureates	l a u r E a t_> E s
laureates	l O r E t_h s
lavheieswa	l a B E i E sw a
lavhelela	l a B E l E l a
lavhelelwa	l a B E l E l w a
lavhelelwaho	l a B E l E l w a h\ O
lavhelesa	l a B E l E s a
lavhelesana	l a B E l E s a n a
lavhelese	l a B E l E s E
lavheleswa	l a B E l E sw a
lavhelewa	l a B E l E w a
lavhelwa	l a B E l w a
law	l a w
law	l O
laṱa	l a t_> a
laṱela	l a t_> E l a
laṱiwa	l a t_> i w a
le	l E
leaders	l E a d_0Z E r s
leaders	l i d E z
league	l E a g u E
league	l i g
leap	l E a p_>
leap	l i p_h
lebanese	l E b a n E s E
lebanese	l E b E n i z
lela	l E l a
lele	l E l E
leludza	l E l u dz a
leluwa	l E l u w a
leluwaho	l E l u w a h\ O
leluwe	l E l u w E
lemelwa	l E m E l w a
lenelo	l E n E l O
lenga	l E n g a
lenge	l E n g E
lengi	l E n g i
lengisa	l E n g i s a
letterheads	l E t_h E h\ E d z
letterheads	l E t_> t_> E r E a d_0Z s
levele	l E v E l E
levha	l E B a
levhela	l E B E l a
li	l i
liana	l E n E
liana	l i a n a
lidza	l i dz a
lidzela	l i dz E l a
lidzelwa	l i dz E l w a
lidziwa	l i dz i w a
lidzwa	l i dz w a
lifha	l i p\ a
lifhasi	l i p\ a s i
lifhasini	l i p\ a s i n i
lifhelwi	l i p\ E l w i
lifhio	l i p\ i O
lifhiwa	l i p\ i w a
liga	l i g a
lihoro	l i h\ O r O
likita	l i k_> i t_> a
lila	l i l a
lilwalo	l i l w a l O
lima	l i m a
lima	l i m E
limited	l E m E t_h E d
limited	l i m i t_> E d_0Z
limiwa	l i m i w a
limiwi	l i m i w i
limpopo	l i m p_> O p_> O
lin	l i n
lindela	l i n d E l a
lindelaho	l i n d E l a h\ O
lindele	l i n d E l E
lindelwa	l i n d E l w a
line	l a n
line	l i n E
linga	l i n g a
lingana	l i n g a n a
linganaho	l i n g a n a h\ O
lingane	l i n g a n E
linganela	l i n g a n E l a
linganelaho	l i n g a n E l a h\ O
lingani	l i n g a n i
linganyisa	l i n g a J i s a
linganyiswa	l i n g a J i sw a
linge	l i n g E
lingea	l i n g E a
lingedza	l i n g E dz a
lingedze	l i n g E dz E
lingedzwa	l i n g E dz w a
lingiwa	l i n g i w a
lingwa	l i n g w a
lini	l i n i
lino	l i n O
linton	l i n t_> O n
linwalo	l i n w a l O
linwe	l i n w E
lisa	l E s E
lisa	l i s a
lisani	l i s a n i
lishivha	l i S i B a
litheresi	l i t_h E r E s i
lithihi	l i t_h i h\ i
litsha	l i tS_h a
litshani	l i tS_h a n i
litshe	l i tS_h E
litshedzelwa	l i tS_h E dz E l w a
litshelani	l i tS_h E l a n i
litshi	l i tS_h i
litshisa	l i tS_h i s a
litshwa	l i tS_h w a
livha	l i B a
livhana	l i B a n a
livhanaho	l i B a n a h\ O
livhanyiswa	l i B a J i sw a
livhanywa	l i B a J w a
livhaṋda	l i B a n d_0Z a
livhisa	l i B i s a
livhise	l i B i s E
livhiswa	l i B i sw a
livhiswaho	l i B i sw a h\ O
livhiwaho	l i B i w a h\ O
livhuwa	l i B u w a
liṅwa	l i n w a
liṅwalo	l i n w a l O
liṅwe	l i n w E
liṋ	l i n
lo	l O
lodzhisitiki	l O dz h\ i s i t_> i k_> i
londa	l O n d a
londola	l O n d O l a
londolwa	l O n d O l w a
londota	l O n d O t_> a
londotana	l O n d O t_> a n a
londotwa	l O n d O t_> w a
lone	l O n
lone	l O n E
longondo	l O n g O n d O
lontshiwa	l O n tS_h i w a
lora	l O r a
losha	l O S a
lossless	l O s l E s
lossless	l O s s l E s s
lot	l O t_>
lot	l O t_h
lothe	l O t_h E
lotto	l O t_h O
lotto	l O t_> t_> O
lounu	l O u n u
lova	l O v a
lovha	l O B a
lovhaho	l O B a h\ O
lovhe	l O B E
lovhela	l O B E l a
lovhelaho	l O B E l a h\ O
lowa	l O w a
lozwa	l O zw a
lozwea	l O zw E a
lu	l u
luafhulelo	l u a p\ u l E l O
luambo	l u a m b O
ludungela	l u d_0Z u n g E l a
ludzhasi	l u dz h\ a s i
lufaṱinga	l u f a t_> i n g a
lufhanga	l u p\ a n g a
lufhia	l u p\ i a
lufu	l u f u
lufule	l u f u l E
lufunela	l u f u n E l a
lufuni	l u f u n i
lufuno	l u f u n O
luga	l u g a
lugaho	l u g a h\ O
luge	l u d_0Z
luge	l u g E
lugela	l u g E l a
lugennge	l u g E n n g E
lugisa	l u g i s a
lugisani	l u g i s a n i
lugise	l u g i s E
lugisela	l u g i s E l a
lugiswa	l u g i sw a
luguvha	l u g u B a
lugwada	l u g w a d_0Z a
luhuhi	l u h\ u h\ i
luhulu	l u h\ u l u
luhulwane	l u h\ u l w a n E
luimbo	l u i m b O
luingo	l u i n g O
lukanda	l u k_> a n d a
luke	l u k_> E
luke	l u k_h
lukhangasa	l u k_h a n g a s a
lukhohe	l u k_h O h\ E
lukisa	l u k_> i s a
lukukwana	l u k_> u k_> w a n a
lulama	l u l a m a
lulamisa	l u l a m i s a
lulamise	l u l a m i s E
lulamiswa	l u l a m i sw a
lulapfu	l u l a p_> f u
lulimi	l u l i m i
lumba	l u m b a
lumbaho	l u m b a h\ O
lumbama	l u m b a m a
lumelisa	l u m E l i s a
lumi	l u m i
lun	l u n
lunako	l u n a k_> O
lunane	l u n a n E
lune	l u n E
lungana	l u n g a n a
lungano	l u n g a n O
lungwa	l u n g w a
luno	l u n O
lunwalo	l u n w a l O
lunwe	l u n w E
lunyadzo	l u J a dz O
lunzhedzana	l u n Z E dz a n a
lunzhi	l u n Z i
lupfumo	l u p_> f u m O
luranga	l u r a n g a
lurumbu	l u r u m b u
lusapho	l u s a p_h O
lushaka	l u S a k_> a
lushakade	l u S a k_> a d_0Z E
luswa	l u sw a
luswayo	l u sw a j O
lutamo	l u t_> a m O
lutanda	l u t_> a n d a
lutendo	l u t_> E n d O
luthihi	l u t_h i h\ i
lutingo	l u t_> i n g O
lutombo	l u t_> O m b O
lutshetshe	l u tS_h E tS_h E
lutswuku	l u ts_> w u k_> u
luvalo	l u v a l O
luvenḓa	l u v E n d a
luvha	l u B a
luvhanḓe	l u B a n d E
luvhele	l u B E l E
luvhelela	l u B E l E l a
luvhi	l u B i
luvhili	l u B i l i
luvhilo	l u B i l O
luvhiloni	l u B i l O n i
luvhiḓi	l u B i d i
luvhola	l u B O l a
luvhone	l u B O n E
luvhonela	l u B O n E l a
luzaho	l u z a h\ O
luṅwalo	l u n w a l O
luṅwe	l u n w E
luṱaha	l u t_> a h\ a
luṱanya	l u t_> a J a
luṱere	l u t_> E r E
luṱingo	l u t_> i n g O
lwa	l w a
lwadza	l w a dz a
lwadzwa	l w a dz w a
lwala	l w a l a
lwalaho	l w a l a h\ O
lwamondo	l w a m O n d O
lwanga	l w a n g a
lwanu	l w a n u
lwanzhe	l w a n Z E
lwanzheni	l w a n Z E n i
lwavho	l w a B O
lwavhu	l w a B u
lwawe	l w a w E
lwayo	l w a j O
lwe	l w E
lwedzana	l w E dz a n a
lwela	l w E l a
lwelwa	l w E l w a
lwendo	l w E n d O
lwenḓo	l w E n d O
lwi	l w i
lwisa	l w i s a
lwisana	l w i s a n a
lwo	l w O
lwone	l w O n E
lwothe	l w O t_h E
lwoṱhe	l w O t_h E
lwu	l w u
lṅa	l n a
ma	m a
maafrika	m a a p\ r i k_> a
maafurika	m a a f u r i k_> a
maambarele	m a a m b a r E l E
maambele	m a a m b E l E
maambiwa	m a a m b i w a
maana	m a a n a
maanda	m a a n d a
maandesa	m a a n d E s a
maanea	m a a n E a
maano	m a a n O
maanḓa	m a a n d a
maanḓafhadza	m a a n d a p\ a dz a
maanḓafhadziswa	m a a n d a p\ a dz i sw a
maapula	m a a p_> u l a
maaṋda	m a a n d_0Z a
maba	m a b a
mabai	m a b a i
mabala	m a b a l a
mabalane	m a b a l a n E
mabalavhali	m a b a l a B a l i
mabambelo	m a b a m b E l O
mabambiri	m a b a m b i r i
mabammbiri	m a b a m b i r i
mabebo	m a b E b O
mabedzane	m a b E dz a n E
maberegisi	m a b E r E g i s i
mabibdu	m a b i b d_0Z u
mabindu	m a b i n d u
mabinduni	m a b i n d u n i
mabofu	m a b O f u
mabogisi	m a b O g i s i
maboho	m a b O h\ O
mabono	m a b O n O
mabu	m a b u
mabulannga	m a b u l a n n g a
mabulasi	m a b u l a s i
mabulasini	m a b u l a s i n i
mabulayo	m a b u l a j O
mabuli	m a b u l i
mabundu	m a b u n d u
mabupo	m a b u p_> O
maburamani	m a b u r a m a n i
maburoho	m a b u r O h\ O
mabuse	m a b u s E
mabutswu	m a b u ts_> w u
mabuḓa	m a b u d a
mabuḓo	m a b u d O
mabvani	m a b v a n i
madaka	m a d_0Z a k_> a
madakani	m a d_0Z a k_> a n i
madalo	m a d_0Z a l O
madambi	m a d_0Z a m b i
madamu	m a d_0Z a m u
madana	m a d_0Z a n a
madanzi	m a d_0Z a n z i
madavhini	m a d_0Z a B i n i
madekwana	m a d_0Z E k_> w a n a
madi	m a d_0Z i
madiba	m a d_0Z i b a
madiko	m a d_0Z i k_> O
madindi	m a d_0Z i n d i
madombidzha	m a d_0Z O m b i dz h\ a
madumbu	m a d_0Z u m b u
maduna	m a d_0Z u n a
maduvha	m a d_0Z u B a
madzanga	m a dz a n g a
madzangalelo	m a dz a n g a l E l O
madzangano	m a dz a n g a n O
madzhango	m a dz h\ a n g O
madzhenele	m a dz h\ E n E l E
madzhesi	m a dz h\ E s i
madzhie	m a dz h\ i E
madzhisi	m a dz h\ i s i
madzhisitarata	m a dz h\ i s i t_> a r a t_> a
madzhisitirata	m a dz h\ i s i t_> i r a t_> a
madzhisiṱaraṱa	m a dz h\ i s i t_> a r a t_> a
madzina	m a dz i n a
madzinambumbano	m a dz i n a m b u m b a n O
madzinge	m a dz i n g E
madzinginywa	m a dz i n g i J w a
madzingu	m a dz i n g u
madzivhani	m a dz i B a n i
madzulele	m a dz u l E l E
madzulo	m a dz u l O
maedza	m a E dz a
maelana	m a E l a n a
maele	m a E l E
maemu	m a E m u
mafasiṱere	m a f a s i t_> E r E
mafeisi	m a f E i s i
mafeladambwa	m a f E l a d_0Z a m b w a
mafeme	m a f E m E
mafhafhu	m a p\ a p\ u
mafhanza	m a p\ a n z a
mafhaṱele	m a p\ a t_> E l E
mafhedziselo	m a p\ E dz i s E l O
mafhelo	m a p\ E l O
mafheloni	m a p\ E l O n i
mafhelonia	m a p\ E l O n i a
mafhi	m a p\ i
mafhugo	m a p\ u g O
mafhumgo	m a p\ u m g O
mafhungo	m a p\ u n g O
mafhungoni	m a p\ u n g O n i
mafhuri	m a p\ u r i
mafobvu	m a f O b v u
mafogisi	m a f O g i s i
mafola	m a f O l a
maforogisi	m a f O r O g i s i
mafulo	m a f u l O
mafulufulo	m a f u l u f u l O
mafulufulu	m a f u l u f u l u
mafuvhalo	m a f u B a l O
maga	m a g a
magadaphele	m a g a d_0Z a p_h E l E
magalangafhasi	m a g a l a n g a p\ a s i
magavhelo	m a g a B E l O
magazine	m a g a z i n E
magazine	m a g E z i n
magidi	m a g i d_0Z i
magokoko	m a g O k_> O k_> O
magona	m a g O n a
magondo	m a g O n d O
magudedzi	m a g u d_0Z E dz i
magumo	m a g u m O
magumoni	m a g u m O n i
maguvha	m a g u B a
maguvhutswera	m a g u B u ts_> w E r a
mahafhe	m a h\ a p\ E
mahala	m a h\ a l a
mahalwa	m a h\ a l w a
mahatsi	m a h\ a ts_> i
mahatsini	m a h\ a ts_> i n i
mahaya	m a h\ a j a
mahayani	m a h\ a j a n i
mahaḓa	m a h\ a d a
mahoro	m a h\ O r O
mahosi	m a h\ O s i
mahoḽa	m a h\ O l a
mahulu	m a h\ u l u
mahulwane	m a h\ u l w a n E
mahumbulwa	m a h\ u m b u l w a
mahumi	m a h\ u m i
mahunguvhu	m a h\ u n g u B u
mahuyu	m a h\ u j u
mai	m a i
maiimo	m a i i m O
mail	m a i l
mail	m E l
maimele	m a i m E l E
maimo	m a i m O
main	m a i n
main	m E n
maindia	m a i n d i a
maine	m a i n E
maine	m E n
maipfi	m a i p_> f i
maisaṱari	m a i s a t_> a r i
maiteie	m a i t_> E i E
maitele	m a i t_> E l E
maitelea	m a i t_> E l E a
maiti	m a i t_> i
maitswane	m a i ts_> w a n E
major	m E d_0Z E r
makana	m a k_> a n a
makanda	m a k_> a n d a
makanga	m a k_> a n g a
maketa	m a k_> E t_> a
makete	m a k_> E t_> E
makha	m a k_h a
makhado	m a k_h a d_0Z O
makhadzi	m a k_h a dz i
makhaha	m a k_h a h\ a
makhaladi	m a k_h a l a d_0Z i
makhotho	m a k_h O t_h O
makhulu	m a k_h u l u
makhwa	m a k_h w a
makolo	m a k_> O l O
makoloko	m a k_> O l O k_> O
makomola	m a k_> O m O l a
makonde	m a k_> O n d E
makone	m a k_> O n E
makovha	m a k_> O B a
makumba	m a k_> u m b a
makumedzwa	m a k_> u m E dz w a
makuya	m a k_> u j a
makwarela	m a k_> w a r E l a
makwati	m a k_> w a t_> i
makwevho	m a k_> w E B O
makwinda	m a k_> w i n d a
mala	m a l a
malabi	m a l a b i
malaho	m a l a h\ O
malamba	m a l a m b a
malana	m a l a n a
malanaho	m a l a n a h\ O
malapfu	m a l a p_> f u
malasha	m a l a S a
malatwa	m a l a t_> w a
malaṱwa	m a l a t_> w a
malederedanzi	m a l E d_0Z E r E d_0Z a n z i
malelebvudzi	m a l E l E b v u dz i
malende	m a l E n d E
malepeng	m a l E p_> E n g
mali	m a l a
mali	m a l i
malisoni	m a l i s O n i
malo	m a l O
malofha	m a l O p\ a
malofhani	m a l O p\ a n i
malombe	m a l O m b E
malombo	m a l O m b O
malugana	m a l u g a n a
malume	m a l u m E
malungana	m a l u n g a n a
maluta	m a l u t_> a
maluvha	m a l u B a
maluvhi	m a l u B i
malwa	m a l w a
malwadze	m a l w a dz E
malwadzwe	m a l w a dz w E
malwaho	m a l w a h\ O
malwanzhe	m a l w a n Z E
mama	m a m a
mama	m a m E
mamaga	m a m a g a
mambo	m a m b O
mamisa	m a m i s a
mamise	m a m i s E
mamiswa	m a m i sw a
man	m a n
mana	m a n a
management	m a n a g E m E n t_>
management	m a n i d_0Z m E n t_h
manakanaka	m a n a k_> a n a k_> a
mananga	m a n a n g a
mandende	m a n d E n d E
mandiwana	m a n d i w a n a
manenzhe	m a n E n Z E
maneto	m a n E t_> O
mangala	m a n g a l a
mangalani	m a n g a l a n i
mangilasini	m a n g i l a s i n i
mangwende	m a n g w E n d E
mani	m a n i
manngo	m a n n g O
mano	m a n O
manwalo	m a n w a l O
manwe	m a n w E
manweledzo	m a n w E l E dz O
manyoro	m a J O r O
manzemba	m a n z E m b a
manzhi	m a n Z i
maonzeni	m a O n z E n i
mapakele	m a p_> a k_> E l E
mapani	m a p_> a n i
mapapawe	m a p_> a p_> a w E
mapate	m a p_> a t_> E
mapfene	m a p_> f E n E
mapfufhi	m a p_> f u p\ i
mapfura	m a p_> f u r a
maphekanywa	m a p_h E k_> a J w a
mapholisa	m a p_h O l i s a
mapholisani	m a p_h O l i s a n i
mapungubwe	m a p_> u n g u b w E
maraga	m a r a g a
marama	m a r a m a
maramba	m a r a m b a
marambo	m a r a m b O
maranga	m a r a n g a
marangaphanḓa	m a r a n g a p_h a n d a
mararu	m a r a r u
march	m a tS_h
mare	m a r E
mare	m E r
marengisele	m a r E n g i s E l E
maria	m a r i a
maria	m E r E
marifhi	m a r i p\ i
marine	m a r i n E
marine	m E r i n
marinini	m a r i n i n i
market	m a k_h E t_h
market	m a r k_> E t_>
marobi	m a r O b i
martial	m a r t_> i a l
martial	m a s E l
marukhu	m a r u k_h u
masaga	m a s a g a
masakona	m a s a k_> O n a
masalela	m a s a l E l a
masana	m a s a n a
masekela	m a s E k_> E l a
maseo	m a s E O
mashaka	m a S a k_> a
mashamba	m a S a m b a
mashango	m a S a n g O
mashangoni	m a S a n g O n i
mashangoḓavha	m a S a n g O d a B a
mashau	m a S a u
mashelelni	m a S E l E l n i
masheleni	m a S E l E n i
mashika	m a S i k_> a
mashonzha	m a S O n Z a
mashubini	m a S u b i n i
mashudu	m a S u d_0Z u
mashumele	m a S u m E l E
mashumisele	m a S u m i s E l E
mashuvhuru	m a S u B u r u
masi	m a s i
masia	m a s i a
masiaari	m a s i a a r i
masiandaitwa	m a s i a n d a i t_> w a
masiandoitwa	m a s i a n d O i t_> w a
masiani	m a s i a n i
masiari	m a s i a r i
masiatari	m a s i a t_> a r i
masiazari	m a s i a z a r i
masiaṱari	m a s i a t_> a r i
masikela	m a s i k_> E l a
masimu	m a s i m u
masindi	m a s i n d i
masipala	m a s i p_> a l a
masisi	m a s i s i
masithesele	m a s i t_h E s E l E
masutu	m a s u t_> u
maswa	m a sw a
maswina	m a sw i n a
maswiri	m a sw i r i
matakadza	m a t_> a k_> a dz a
matambavhana	m a t_> a m b a B a n a
matambule	m a t_> a m b u l E
matanda	m a t_> a n d a
matano	m a t_> a n O
matavhi	m a t_> a B i
mathabama	m a t_h a b a m a
mathada	m a t_h a d_0Z a
mathemu	m a t_h E m u
mathenga	m a t_h E n g a
matheriala	m a t_h E r i a l a
matheriaḽa	m a t_h E r i a l a
mathina	m a t_h i n a
matholetwe	m a t_h O l E t_> w E
mathomela	m a t_h O m E l a
mathomele	m a t_h O m E l E
mathomo	m a t_h O m O
mathomoni	m a t_h O m O n i
mathubwa	m a t_h u b w a
mathukhwi	m a t_h u k_h w i
matidze	m a t_> i dz E
mato	m a t_> O
matodzi	m a t_> O dz i
matokha	m a t_> O k_h a
matombo	m a t_> O m b O
matoni	m a t_> O n i
matope	m a t_> O p_> E
matshaina	m a tS_h a i n a
matshelo	m a tS_h E l O
matshelonitsheloni	m a tS_h E l O n i tS_h E l O n i
matshilele	m a tS_h i l E l E
matshilisano	m a tS_h i l i s a n O
matshilo	m a tS_h i l O
matshimbidzele	m a tS_h i m b i dz E l E
matshimbidzelwe	m a tS_h i m b i dz E l w E
matshudeni	m a tS_h u d_0Z E n i
matshwayo	m a tS_h w a j O
matsiko	m a ts_> i k_> O
matsilu	m a ts_> i l u
matsinde	m a ts_> i n d E
matsivha	m a ts_> i B a
matswiani	m a ts_> w i a n i
matswu	m a ts_> w u
matuku	m a t_> u k_> u
matungo	m a t_> u n g O
mauku	m a u k_> u
mauluma	m a u l u m a
maungani	m a u n g a n i
maureen	m a u r E E n
maureen	m O r i n
mauvha	m a u B a
mavhadzi	m a B a dz i
mavhaka	m a B a k_> a
mavharivhari	m a B a r i B a r i
mavhava	m a B a v a
mavhele	m a B E l E
mavhengele	m a B E n g E l E
mavhengeleni	m a B E n g E l E n i
mavhi	m a B i
mavhili	m a B i l i
mavhone	m a B O n E
mavhudzi	m a B u dz i
mavhulungele	m a B u l u n g E l E
mavhungo	m a B u n g O
mavhuru	m a B u r u
mavhuvhisi	m a B u B i s i
mavili	m a v i l i
mavothi	m a v O t_h i
mavoḓa	m a v O d a
mavu	m a v u
mavun	m a v u n
mavund	m a v u n d
mavundu	m a v u n d u
mavuni	m a v u n i
mavunu	m a v u n u
mavununi	m a v u n u n i
mavunḓu	m a v u n d u
mavuṋdu	m a v u n d_0Z u
mawalo	m a w a l O
mawanwa	m a w a n w a
mawe	m a w E
mawela	m a w E l a
mazda	m a z d_0Z a
mazennge	m a z E n n g E
mazhana	m a Z a n a
mazhendedzi	m a Z E n d E dz i
mazhinda	m a Z i n d a
mazwilu	m a zw i l u
maḓabula	m a d a b u l a
maḓaganana	m a d a g a n a n a
maḓaka	m a d a k_> a
maḓala	m a d a l a
maḓamu	m a d a m u
maḓi	m a d i
maḓini	m a d i n i
maḓumbu	m a d u m b u
maḓuvha	m a d u B a
maḽe	m a l E
maḽeḓere	m a l E d E r E
maḽinga	m a l i n g a
maṅwaelo	m a n w a E l O
maṅwalo	m a n w a l O
maṅwalwa	m a n w a l w a
maṅwe	m a n w E
maṋa	m a n a
maṋiini	m a n i i n i
maṋo	m a n O
maṋwalo	m a n w a l O
maṋwalwa	m a n w a l w a
maṋwe	m a n w E
maṱamatisi	m a t_> a m a t_> i s i
maṱamaṱisi	m a t_> a m a t_> i s i
maṱamvu	m a t_> a m v u
maṱanganyi	m a t_> a n g a J i
maṱangari	m a t_> a n g a r i
maṱano	m a t_> a n O
maṱanu	m a t_> a n u
maṱari	m a t_> a r i
maṱo	m a t_> O
maṱoni	m a t_> O n i
maṱorokisi	m a t_> O r O k_> i s i
maṱudzi	m a t_> u dz i
maṱuku	m a t_> u k_> u
mb	E m b i
mba	m b a
mbabvu	m b a b v u
mbadelo	m b a d_0Z E l O
mbadeloi	m b a d_0Z E l O i
mbalelano	m b a l E l a n O
mbalo	m b a l O
mbalogu	m b a l O g u
mbamba	m b a m b a
mbambadzo	m b a m b a dz O
mbambe	m b a m b E
mbandelo	m b a n d E l O
mbanzhe	m b a n Z E
mbava	m b a v a
mbebo	m b E b O
mbekamishumo	m b E k_> a m i S u m O
mbekanya	m b E k_> a J a
mbekanyagwama	m b E k_> a J a g w a m a
mbekanyamaitele	m b E k_> a J a m a i t_> E l E
mbekanyamishumo	m b E k_> a J a m i S u m O
mbekanyamitele	m b E k_> a J a m i t_> E l E
mbekanyamushumo	m b E k_> a J a m u S u m O
mbekanyanamaitele	m b E k_> a J a n a m a i t_> E l E
mbekanyo	m b E k_> a J O
mbekenyamaitele	m b E k_> E J a m a i t_> E l E
mbetshelo	m b E tS_h E l O
mbetshelwa	m b E tS_h E l w a
mbeu	m b E u
mbevha	m b E B a
mbila	m b i l a
mbilaelo	m b i l a E l O
mbilahelo	m b i l a h\ E l O
mbili	m b i l i
mbilo	m b i l O
mbilu	m b i l u
mbiluni	m b i l u n i
mbilwi	m b i l w i
mbingano	m b i n g a n O
mbiti	m b i t_> i
mbo	m b O
mbofho	m b O p\ O
mbofholowo	m b O p\ O l O w O
mboma	m b O m a
mbonalelo	m b O n a l E l O
mbonalo	m b O n a l O
mbonelaphanḓa	m b O n E l a p_h a n d a
mbono	m b O n O
mbu	m b u
mbubana	m b u b a n a
mbudzi	m b u dz i
mbudziso	m b u dz i s O
mbuelo	m b u E l O
mbulugelo	m b u l u g E l O
mbulungelo	m b u l u n g E l O
mbulungo	m b u l u n g O
mbulungoni	m b u l u n g O n i
mbumbano	m b u m b a n O
mbumbo	m b u m b O
mbuno	m b u n O
mbuvha	m b u B a
mbuyavhuhadzi	m b u j a B u h\ a dz i
mbuyedza	m b u j E dz a
mbuyelo	m b u j E l O
mbwandamela	m b w a n d a m E l a
mec	m E k_h
media	m E d_0Z i a
media	m i d E
medical	m E d i k_h E l
meili	m E i l i
mela	m E l a
member	m E m b E r
members	m E m b E r s
members	m E m b E z
meme	m E m E
memorandamu	m E m O r a n d a m u
mentshisi	m E n tS_h i s i
mepe	m E p_> E
mesina	m E s i n a
meta	m E t_> a
mfarisa	m f a r i s a
miaisano	m i a i s a n O
miangano	m i a n g a n O
miano	m i a n O
miaro	m i a r O
miau	m i a u
mibomo	m i b O m O
mibvumo	m i b v u m O
michigan	m i s i g E n
midi	m i d_0Z i
midia	m i d_0Z i a
midini	m i d_0Z i n i
midzi	m i dz i
midzini	m i dz i n i
migaganyagwama	m i g a g a J a g w a m a
migodi	m i g O d_0Z i
migodini	m i g O d_0Z i n i
mihaelo	m i h\ a E l O
mihaelomuvhigo	m i h\ a E l O m u B i g O
mihafukhada	m i h\ a f u k_h a d_0Z a
mihasho	m i h\ a S O
mihayo	m i h\ a j O
mihoho	m i h\ O h\ O
miholo	m i h\ O l O
mihulu	m i h\ u l u
mihulwane	m i h\ u l w a n E
mihumbulo	m i h\ u m b u l O
mihumbuloni	m i h\ u m b u l O n i
mihwalo	m i h\ w a l O
mikando	m i k_> a n d O
mikano	m i k_> a n O
mikaṋoni	m i k_> a n O n i
mikhukhu	m i k_h u k_h u
mikhwa	m i k_h w a
mikosi	m i k_> O s i
mikota	m i k_> O t_> a
mikovhe	m i k_> O B E
mikoṱa	m i k_> O t_> a
mikumba	m i k_> u m b a
mila	m i l a
milaedza	m i l a E dz a
milambo	m i l a m b O
milamboni	m i l a m b O n i
milandu	m i l a n d u
milanga	m i l a n g a
milapfu	m i l a p_> f u
milayo	m i l a j O
milayonyana	m i l a j O J a n a
milayotibe	m i l a j O t_> i b E
milenzhe	m i l E n Z E
milenzheni	m i l E n Z E n i
mililani	m i l i l a n i
mililo	m i l i l O
milioni	m i l i O n i
milisa	m i l i s a
miliswa	m i l i sw a
military	m i l i t_> a r j
military	m i l i t_h r i
miliwa	m i l i w a
million	m i l E n
million	m i l l i O n
milomo	m i l O m O
miloro	m i l O r O
mimakete	m i m a k_> E t_> E
mimanngi	m i m a n n g i
mimapa	m i m a p_> a
mimaraga	m i m a r a g a
mimasipala	m i m a s i p_> a l a
mimepe	m i m E p_> E
mimetshe	m i m E tS_h E
mimishini	m i m i S i n i
mimodele	m i m O d_0Z E l E
mimuya	m i m u j a
mina	m i n a
mindaandaane	m i n d a a n d a a n E
mindende	m i n d E n d E
minerala	m i n E r a l a
minerale	m i n E r a l E
minetse	m i n E ts_> E
mini	m i n i
minidzhere	m i n i dz h\ E r E
minirala	m i n i r a l a
minis	m i n i s
minisia	m i n i s i a
minisita	m i n i s i t_> a
minisiṱa	m i n i s i t_> a
minista	m i n i s t_> a
minister	m E n E s t_h E r
minister	m i n i s t_> E r
minithi	m i n i t_h i
minor	m a n E r
minor	m i n O r
mintek	m i n t_> E k_>
minula	m i n u l a
minwaha	m i n w a h\ a
minwe	m i n w E
minwedzi	m i n w E dz i
minyikelo	m i J i k_> E l O
minzhi	m i n Z i
miomva	m i O m v a
mipaini	m i p_> a i n i
mipengo	m i p_> E n g O
mipfufhi	m i p_> f u p\ i
mirado	m i r a d_0Z O
mirafho	m i r a p\ O
mirao	m i r a O
miraru	m i r a r u
miratho	m i r a t_h O
miraḓo	m i r a d O
mirengelano	m i r E n g E l a n O
mirerala	m i r E r a l a
mirero	m i r E r O
miri	m i r i
miroho	m i r O h\ O
mirumba	m i r u m b a
mirunzi	m i r u n z i
misanda	m i s a n d a
misevhe	m i s E B E
mishahani	m i S a h\ a n i
mishashani	m i S a S a n i
mishinini	m i S i n i n i
mishonga	m i S O n g a
mishongo	m i S O n g O
mishumo	m i S u m O
mishumoni	m i S u m O n i
mishushedzo	m i S u S E dz O
misi	m i s i
misipha	m i s i p_h a
misumbedzo	m i s u m b E dz O
miswa	m i sw a
miswaswo	m i sw a sw O
mita	m i t_> a
mitala	m i t_> a l a
mitaladzi	m i t_> a l a dz i
mitalo	m i t_> a l O
mitambo	m i t_> a m b O
mitangano	m i t_> a n g a n O
mitanganoni	m i t_> a n g a n O n i
mitengo	m i t_> E n g O
mitete	m i t_> E t_> E
mitetemelo	m i t_> E t_> E m E l O
mitevhe	m i t_> E B E
mithara	m i t_h a r a
mithelo	m i t_h E l O
mithenga	m i t_h E n g a
mitshelo	m i tS_h E l O
mitshila	m i tS_h i l a
mitshini	m i tS_h i n i
mitshinyadzo	m i tS_h i J a dz O
mitsho	m i tS_h O
mitsiko	m i ts_> i k_> O
mitsindo	m i ts_> i n d O
mitupo	m i t_> u p_> O
mivhala	m i B a l a
mivhango	m i B a n g O
mivhi	m i B i
mivhigo	m i B i g O
mivhili	m i B i l i
mivhilini	m i B i l i n i
mivhundu	m i B u n d u
mivhuso	m i B u s O
mivhusoyapo	m i B u s O j a p_> O
miwaha	m i w a h\ a
miwe	m i w E
mixed	m i k_h s t_h
mixed	m i x E d_0Z
miḓi	m i d i
miḓini	m i d i n i
miṅadzi	m i n a dz i
miṅwaha	m i n w a h\ a
miṅwahani	m i n w a h\ a n i
miṅwe	m i n w E
miṅwedzi	m i n w E dz i
miṅwedzini	m i n w E dz i n i
miṋa	m i n a
miṋu	m i n u
miṋwe	m i n w E
miṱa	m i t_> a
miṱana	m i t_> a n a
miṱangano	m i t_> a n g a n O
miṱanganoni	m i t_> a n g a n O n i
miṱani	m i t_> a n i
miṱanu	m i t_> a n u
miṱodzi	m i t_> O dz i
mma	m a
mmawe	m a w E
mmbekanyamushumo	m b E k_> a J a m u S u m O
mmbengeni	m b E n g E n i
mmbengwa	m b E n g w a
mmbeteni	m b E t_> E n i
mmbi	m b i
mmbwa	m b w a
mme	m E
mmeni	m E n i
moaba	m O a b a
moano	m O a n O
modele	m O d_0Z E l E
modern	m O d_0Z E r n
modern	m O d E n
mona	m O n a
monarchs	m O n E k_h s
monday	m a n d E
monday	m O n d a j
monde	m O n d E
mondi	m O n d i
monetary	m a n i t_h r i
monetary	m O n E t_> a r j
monitha	m O n i t_h a
monithara	m O n i t_h a r a
monithariwa	m O n i t_h a r i w a
monokosaidi	m O n O k_> O s a i d_0Z i
mortality	m O r t_> a l i t_h
mortality	m O t_h a l E t_h i
moscow	m O s k_h O
moḓoro	m O d O r O
mpama	m p_> a m a
mpfarele	m p_> f a r E l E
mpfo	m p_> f O
mpfu	m p_> f u
mphagane	m p_h a g a n E
mphaphuli	m p_h a p_h u l i
mphephu	m p_h E p_h u
mphindula	m p_h i n d u l a
mphire	m p_h i r E
mpho	m p_h O
mphomali	m p_h O m a l i
mphunga	m p_h u n g a
mpimo	m p_> i m O
mpomali	m p_> O m a l i
mtakalo	m t_> a k_> a l O
mu	m u
mua	m u a
muagasi	m u a g a s i
muaifa	m u a i f a
muaisano	m u a i s a n O
mualuwa	m u a l u w a
muambeli	m u a m b E l i
muambi	m u a m b i
muambo	m u a m b O
muandadzo	m u a n d a dz O
muanetsheli	m u a n E tS_h E l i
muanewa	m u a n E w a
muangarambo	m u a n g a r a m b O
muano	m u a n O
muaphili	m u a p_h i l i
muaro	m u a r O
mubadeli	m u b a d_0Z E l i
mubadelwa	m u b a d_0Z E l w a
mubebi	m u b E b i
mubhann	m u b a n n
mubindudzi	m u b i n d u dz i
mubvana	m u b v a n a
mubvann	m u b v a n n
mubveledzi	m u b v E l E dz i
mubvumbedzwa	m u b v u m b E dz w a
mubvumo	m u b v u m O
mudagasi	m u d_0Z a g a s i
mudagsai	m u d_0Z a g s a i
mudala	m u d_0Z a l a
mudau	m u d_0Z a u
mudedekadzi	m u d_0Z E d_0Z E k_> a dz i
mudini	m u d_0Z i n i
mudzi	m u dz i
mudzimu	m u dz i m u
mudzio	m u dz i O
mudzudzanyi	m u dz u dz a J i
mudzula	m u dz u l a
mudzulapo	m u dz u l a p_> O
mudzulatshidulo	m u dz u l a tS_h i d_0Z u l O
mudzuli	m u dz u l i
mudzumbamo	m u dz u m b a m O
mudzunga	m u dz u n g a
mue	m u E
mueditha	m u E d_0Z i t_h a
muedzini	m u E dz i n i
mueletshedzi	m u E l E tS_h E dz i
muelo	m u E l O
muendeulu	m u E n d E u l u
muengedzo	m u E n g E dz O
mufaramukovhe	m u f a r a m u k_> O B E
mufarisa	m u f a r i s a
mufarisi	m u f a r i s i
mufariwa	m u f a r i w a
mufaro	m u f a r O
mufarwa	m u f a r w a
mufhe	m u p\ E
mufhindulano	m u p\ i n d u l a n O
mufhiri	m u p\ i r i
mufhirifhiri	m u p\ i r i p\ i r i
mufhoho	m u p\ O h\ O
mufisi	m u f i s i
mufu	m u f u
mufuda	m u f u d_0Z a
mufumakadzi	m u f u m a k_> a dz i
mufunwa	m u f u n w a
mufuvha	m u f u B a
mugaganyagwama	m u g a g a J a g w a m a
mugaganyo	m u g a g a J O
mugarantii	m u g a r a n t_> i i
mugayo	m u g a j O
mugodi	m u g O d_0Z i
mugudi	m u g u d_0Z i
mugudisi	m u g u d_0Z i s i
mugudiswa	m u g u d_0Z i sw a
mugugumelani	m u g u g u m E l a n i
mugumoni	m u g u m O n i
mugwabama	m u g w a b a m a
mugwabana	m u g w a b a n a
mugwalabo	m u g w a l a b O
muhahsho	m u h\ a h\ S O
muhali	m u h\ a l i
muhanelwa	m u h\ a n E l w a
muhanga	m u h\ a n g a
muhasho	m u h\ a S O
muhashoni	m u h\ a S O n i
muhatuli	m u h\ a t_> u l i
muhayo	m u h\ a j O
muhaṱuli	m u h\ a t_> u l i
muhoha	m u h\ O h\ a
muholo	m u h\ O l O
muhoyo	m u h\ O j O
muhula	m u h\ u l a
muhulu	m u h\ u l u
muhulua	m u h\ u l u a
muhulwane	m u h\ u l w a n E
muhumbeli	m u h\ u m b E l i
muhumbulelwa	m u h\ u m b u l E l w a
muhumbulo	m u h\ u m b u l O
muhumbuloni	m u h\ u m b u l O n i
muhura	m u h\ u r a
muhwalo	m u h\ w a l O
muhweleli	m u h\ w E l E l i
muhwelelwa	m u h\ w E l E l w a
muiangi	m u i a n g i
muila	m u i l a
muilafuri	m u i l a f u r i
muimana	m u i m a n a
muimeleli	m u i m E l E l i
muimeli	m u i m E l i
muingameli	m u i n g a m E l i
muiti	m u i t_> i
mukalaha	m u k_> a l a h\ a
mukano	m u k_> a n O
mukapi	m u k_> a p_> i
mukegulu	m u k_> E g u l u
mukhantselara	m u k_h a n ts_> E l a r a
mukhwama	m u k_h w a m a
mukolodi	m u k_> O l O d_0Z i
mukololo	m u k_> O l O l O
mukoma	m u k_> O m a
mukomana	m u k_> O m a n a
mukomani	m u k_> O m a n i
mukosi	m u k_> O s i
mukovhe	m u k_> O B E
mukula	m u k_> u l a
mukumba	m u k_> u m b a
mukumbani	m u k_> u m b a n i
mukumbi	m u k_> u m b i
mul	m u l
mulaedza	m u l a E dz a
mulaifa	m u l a i f a
mulala	m u l a l a
mulalo	m u l a l O
mulambadzea	m u l a m b a dz E a
mulambo	m u l a m b O
mulamboni	m u l a m b O n i
mulamukanyi	m u l a m u k_> a J i
mulanda	m u l a n d a
mulandu	m u l a n d u
mulanga	m u l a n g a
mulangadzulo	m u l a n g a dz u l O
mulangi	m u l a n g i
mulanguli	m u l a n g u l i
mulangulidzhenerala	m u l a n g u l i dz h\ E n E r a l a
mulanu	m u l a n u
mulapfu	m u l a p_> f u
mulauli	m u l a u l i
mulayo	m u l a j O
mulayoni	m u l a j O n i
mulayotewa	m u l a j O t_> E w a
mulayotibe	m u l a j O t_> i b E
mulenzhe	m u l E n Z E
mulevho	m u l E B O
muleḓane	m u l E d a n E
mulilo	m u l i l O
mulima	m u l i m a
mulimavho	m u l i m a B O
mulimi	m u l i m i
mulimo	m u l i m O
mulindagehte	m u l i n d a g E t_> E
mulindakhombo	m u l i n d a k_h O m b O
mulindini	m u l i n d i n i
mulingo	m u l i n g O
mulisa	m u l i s a
mulodzi	m u l O dz i
muloi	m u l O i
mulomo	m u l O m O
mulomoni	m u l O m O n i
mulondoti	m u l O n d O t_> i
muloro	m u l O r O
mulovha	m u l O B a
muloza	m u l O z a
mulwadze	m u l w a dz E
mulwi	m u l w i
mun	m u n
munameli	m u n a m E l i
munango	m u n a n g O
munangoni	m u n a n g O n i
mundende	m u n d E n d E
mundendeni	m u n d E n d E n i
mune	m u n E
munekedzi	m u n E k_> E dz i
munetshedzi	m u n E tS_h E dz i
mungafha	m u n g a p\ a
mungome	m u n g O m E
munna	m u n n a
muno	m u n O
munthu	m u n t_h u
munukho	m u n u k_h O
munwaho	m u n w a h\ O
munwe	m u n w E
munwi	m u n w i
munyanya	m u J a J a
munzhi	m u n Z i
muoditha	m u O d_0Z i t_h a
muofisi	m u O f i s i
muofisiri	m u O f i s i r i
muomva	m u O m v a
muongi	m u O n g i
mupandamedzi	m u p_> a n d a m E dz i
mupeleto	m u p_> E l E t_> O
mupeleṱo	m u p_> E l E t_> O
mupendelo	m u p_> E n d E l O
mupfufhi	m u p_> f u p\ i
mupha	m u p_h a
muphabulisi	m u p_h a b u l i s i
muphuresidennde	m u p_h u r E s i d_0Z E n n d E
muphurofeshinala	m u p_h u r O f E S i n a l a
mupo	m u p_> O
mupondiwa	m u p_> O n d i w a
mupondwa	m u p_> O n d w a
murabi	m u r a b i
murado	m u r a d_0Z O
muraho	m u r a h\ O
murahu	m u r a h\ u
murambo	m u r a m b O
murangaphana	m u r a n g a p_h a n a
murangaphanḓa	m u r a n g a p_h a n d a
murao	m u r a O
murathu	m u r a t_h u
muraḓo	m u r a d O
muredzhisitarara	m u r E dz h\ i s i t_> a r a r a
mureili	m u r E i l i
mureiḽi	m u r E i l i
murema	m u r E m a
murendi	m u r E n d i
murengi	m u r E n g i
murengisi	m u r E n g i s i
murero	m u r E r O
muri	m u r i
murobi	m u r O b i
muroho	m u r O h\ O
murole	m u r O l E
murumba	m u r u m b a
murumbulasheḓo	m u r u m b u l a S E d O
murundu	m u r u n d u
murungi	m u r u n g i
murunwa	m u r u n w a
murunzi	m u r u n z i
musadzi	m u s a dz i
musaini	m u s a i n i
musalauno	m u s a l a u n O
musalauḽa	m u s a l a u l a
musanda	m u s a n d a
musevhetho	m u s E B E t_h O
musevhethoni	m u s E B E t_h O n i
mushonga	m u S O n g a
mushongahoyu	m u S O n g a h\ O j u
mushumela	m u S u m E l a
mushumeli	m u S u m E l i
mushumelwa	m u S u m E l w a
mushumi	m u S u m i
mushumisani	m u S u m i s a n i
mushumisi	m u S u m i s i
mushumo	m u S u m O
mushumoni	m u S u m O n i
musi	m u s i
music	m j u z i k_h
musidzana	m u s i dz a n a
musina	m u s i n a
musisi	m u s i s i
musiwana	m u s i w a n a
musudzuluwo	m u s u dz u l u w O
musuku	m u s u k_> u
musukuvhutshilo	m u s u k_> u B u tS_h i l O
musumbuluwo	m u s u m b u l u w O
musundwa	m u s u n d w a
musunzi	m u s u n z i
muswa	m u sw a
muswuhana	m u sw u h\ a n a
muta	m u t_> a
mutakalo	m u t_> a k_> a l O
mutala	m u t_> a l a
mutaladzi	m u t_> a l a dz i
mutale	m u t_> a l E
mutambo	m u t_> a m b O
mutambudziwa	m u t_> a m b u dz i w a
mutambule	m u t_> a m b u l E
mutandululi	m u t_> a n d u l u l i
mutanganedzi	m u t_> a n g a n E dz i
mutangano	m u t_> a n g a n O
mutani	m u t_> a n i
mutendelo	m u t_> E n d E l O
mutendi	m u t_> E n d i
mutengo	m u t_> E n g O
mutete	m u t_> E t_> E
mutevhe	m u t_> E B E
mutevhethandu	m u t_> E B E t_h a n d u
muthada	m u t_h a d_0Z a
muthannga	m u t_h a n n g a
mutheli	m u t_h E l i
muthelo	m u t_h E l O
muthelogu	m u t_h E l O g u
mutheo	m u t_h E O
muthetho	m u t_h E t_h O
muthetshelo	m u t_h E tS_h E l O
muthihi	m u t_h i h\ i
mutholi	m u t_h O l i
mutholiwa	m u t_h O l i w a
muthu	m u t_h u
muthude	m u t_h u d_0Z E
muthula	m u t_h u l a
muthusa	m u t_h u s a
mutikedzelo	m u t_> i k_> E dz E l O
mutodo	m u t_> O d_0Z O
mutoga	m u t_> O g a
mutoli	m u t_> O l i
mutsha	m u tS_h a
mutshangana	m u tS_h a n g a n a
mutshekwa	m u tS_h E k_> w a
mutshelo	m u tS_h E l O
mutshena	m u tS_h E n a
mutshidzi	m u tS_h i dz i
mutshila	m u tS_h i l a
mutshilitshili	m u tS_h i l i tS_h i l i
mutshimbidzi	m u tS_h i m b i dz i
mutshini	m u tS_h i n i
mutshino	m u tS_h i n O
mutshinyalo	m u tS_h i J a l O
mutshinyi	m u tS_h i J i
mutsho	m u tS_h O
mutshutshisi	m u tS_h u tS_h i s i
mutshutshu	m u tS_h u tS_h u
mutsi	m u ts_> i
mutsiko	m u ts_> i k_> O
mutsinda	m u ts_> i n d a
mutsindo	m u ts_> i n d O
mutsireledzi	m u ts_> i r E l E dz i
mutswu	m u ts_> w u
mutswuku	m u ts_> w u k_> u
mutukana	m u t_> u k_> a n a
mutuku	m u t_> u k_> u
mutukutuku	m u t_> u k_> u t_> u k_> u
mutumbu	m u t_> u m b u
muuku	m u k_> u
muungo	m u n g O
muunḓi	m u n d i
muvango	m u v a n g O
muvend	m u v E n d
muvenḓa	m u v E n d a
muvhala	m u B a l a
muvhalelano	m u B a l E l a n O
muvhali	m u B a l i
muvhango	m u B a n g O
muvhi	m u B i
muvhidzeleli	m u B i dz E l E l i
muvhidzi	m u B i dz i
muvhigi	m u B i g i
muvhigo	m u B i g O
muvhilaeli	m u B i l a E l i
muvhilaheli	m u B i l a h\ E l i
muvhilaleli	m u B i l a l E l i
muvhili	m u B i l i
muvhilini	m u B i l i n i
muvhulungi	m u B u l u n g i
muvhundu	m u B u n d u
muvhunduni	m u B u n d u n i
muvhuso	m u B u s O
muvhusoni	m u B u s O n i
muvhusowapo	m u B u s O w a p_> O
muvhuye	m u B u j E
muvhuyu	m u B u j u
muvula	m u v u l a
muwani	m u w a n i
muwaweni	m u w a w E n i
muwe	m u w E
muya	m u j a
muyani	m u j a n i
muziamu	m u z i a m u
muzika	m u z i k_> a
muzulu	m u z u l u
muzwala	m u zw a l a
muḓagasi	m u d a g a s i
muḓi	m u d i
muḓini	m u d i n i
muḽa	m u l a
muḽagalu	m u l a g a l u
muḽaifa	m u l a i f a
muḽambilu	m u l a m b i l u
muḽani	m u l a n i
muḽoro	m u l O r O
muṅadzi	m u n a dz i
muṅene	m u N E n E
muṅwaleli	m u n w a l E l i
muṅwali	m u n w a l i
muṅwalisi	m u n w a l i s i
muṅwe	m u n w E
muṋango	m u n a n g O
muṋangoni	m u n a n g O n i
muṋe	m u n E
muṋetshedzi	m u n E tS_h E dz i
muṋwe	m u n w E
muṱa	m u t_> a
muṱahabvu	m u t_> a h\ a b v u
muṱanganedzi	m u t_> a n g a n E dz i
muṱangano	m u t_> a n g a n O
muṱanganoni	m u t_> a n g a n O n i
muṱani	m u t_> a n i
muṱavha	m u t_> a B a
muṱavhatsindi	m u t_> a B a ts_> i n d i
muṱaḓa	m u t_> a d a
muṱhannga	m u t_h a n n g a
muṱhanngana	m u t_h a n n g a n a
muṱhogomeli	m u t_h O g O m E l i
muṱo	m u t_> O
muṱoḓo	m u t_> O d O
muṱuku	m u t_> u k_> u
mveladziso	m v E l a dz i s O
mvelapha	m v E l a p_h a
mvelaphan	m v E l a p_h a n
mvelaphana	m v E l a p_h a n a
mvelaphand	m v E l a p_h a n d
mvelaphanda	m v E l a p_h a n d a
mvelaphanḓa	m v E l a p_h a n d a
mveledziso	m v E l E dz i s O
mveledzisophan	m v E l E dz i s O p_h a n
mveledzo	m v E l E dz O
mvelele	m v E l E l E
mvelelo	m v E l E l O
mvukululo	m v u k_> u l u l O
mvula	m v u l a
mvumbo	m v u m b O
mvumvusa	m v u m v u s a
mvun	m v u n
mvuseledzo	m v u s E l E dz O
mvusuludzo	m v u s u l u dz O
mvuvhelo	m v u B E l O
mvuḓi	m v u d i
mwemwele	m w E m w E l E
n	E n
na	n a
naa	n a a
nadzo	n a dz O
nae	n a E
nafu	n a f u
naho	n a h\ O
nahone	n a h\ O n E
naka	n a k_> a
nakaho	n a k_> a h\ O
nake	n a k_> E
naki	n a k_> i
nakisa	n a k_> i s a
nakiswa	n a k_> i sw a
nakiswaho	n a k_> i sw a h\ O
nakudze	n a k_> u dz E
nala	n a l a
nama	n a m a
namba	n a m b a
nambatedza	n a m b a t_> E dz a
nambatedzwa	n a m b a t_> E dz w a
nambatela	n a m b a t_> E l a
nambatsedzwa	n a m b a ts_> E dz w a
nambe	n a m b E
namedza	n a m E dz a
namedzaho	n a m E dz a h\ O
namela	n a m E l a
namusi	n a m u s i
nan	n a n
nana	n a n a
nandunzhendunzhe	n a n d u n Z E n d u n Z E
nane	n a n E
nanela	n a n E l a
nanga	n a n g a
nange	n a n g E
nangelwa	n a n g E l w a
nangiwa	n a n g i w a
nangiwaho	n a n g i w a h\ O
nangoho	n a n g O h\ O
nanguludza	n a n g u l u dz a
nanguludzani	n a n g u l u dz a n i
nangwaho	n a n g w a h\ O
nangwe	n a n g w E
nangweni	n a n g w E n i
nani	n a n i
nao	n a O
narina	n a r i n a
natala	n a t_> a l a
national	n a s E n E l
national	n a t_> i O n a l
nations	n a t_> i O n s
nations	n E s E n z
native	n a t_> i v E
native	n E t_h E v
natshitunde	n a tS_h i t_> u n d E
natsho	n a tS_h O
natural	n a tS_h r E l
natural	n a t_> u r a l
navha	n a B a
navhannavha	n a B a n n a B a
navhisa	n a B i s a
navho	n a B O
navy	n a B j
navy	n E v i
nawa	n a w a
nawo	n a w O
nay	n a j
nay	n E
nayo	n a j O
nazwavho	n a zw a B O
nazwino	n a zw i n O
nazwo	n a zw O
naḽo	n a l O
nd	E n d i
nda	n d a
ndaela	n d a E l a
ndaka	n d a k_> a
ndalukano	n d a l u k_> a n O
ndalukanyo	n d a l u k_> a J O
ndambedzo	n d a m b E dz O
ndamgulo	n d a m g u l O
ndango	n d a n g O
ndangulo	n d a n g u l O
ndapfu	n d a p_> f u
ndatiso	n d a t_> i s O
ndau	n d a u
ndaula	n d a u l a
ndaulo	n d a u l O
ndavha	n d a B a
ndavhelelo	n d a B E l E l O
ndayo	n d a j O
ndayotewa	n d a j O t_> E w a
ndaṱiso	n d a t_> i s O
ndebvu	n d E b v u
ndededzo	n d E d_0Z E dz O
ndele	n d E l E
ndeme	n d E m E
ndemesa	n d E m E s a
ndenya	n d E J a
ndi	n d i
ndiafhi	n d i a p\ i
ndifhelo	n d i p\ E l O
ndifhiso	n d i p\ i s O
ndigo	n d i g O
ndila	n d i l a
ndilani	n d i l a n i
ndiliso	n d i l i s O
ndima	n d i m a
ndimana	n d i m a n a
ndimo	n d i m O
ndindakhombo	n d i n d a k_h O m b O
ndingano	n d i n g a n O
ndinganyelo	n d i n g a J E l O
ndinganyiso	n d i n g a J i s O
ndinganyo	n d i n g a J O
ndingedzo	n d i n g E dz O
ndingo	n d i n g O
ndisedzo	n d i s E dz O
ndishi	n d i S i
ndishini	n d i S i n i
nditsheni	n d i tS_h E n i
ndivhadzo	n d i B a dz O
ndivho	n d i B O
ndivhoyapo	n d i B O j a p_> O
ndo	n d O
ndode	n d O d_0Z E
ndondolamutakalo	n d O n d O l a m u t_> a k_> a l O
ndondolo	n d O n d O l O
ndongazwiga	n d O n g a zw i g a
ndovhedzo	n d O B E dz O
ndovhololo	n d O B O l O l O
ndowelo	n d O w E l O
ndowendowe	n d O w E n d O w E
ndozwo	n d O zw O
ndugelo	n d u g E l O
ndugiselo	n d u g i s E l O
nduhune	n d u h\ u n E
ndumbo	n d u m b O
ndumi	n d u m i
nduna	n d u n a
ndungelo	n d u n g E l O
ndungiselo	n d u n g i s E l O
nduni	n d u n i
ndunzhendunzhe	n d u n Z E n d u n Z E
ndunzhenzhe	n d u n Z E n Z E
nduvho	n d u B O
ndzhia	n d h\ i a
ne	n E
nea	n E a
neani	n E a n i
nee	n E E
neeni	n E E n i
nekedza	n E k_> E dz a
nekedze	n E k_> E dz E
nekedzwa	n E k_> E dz w a
nekedzwaho	n E k_> E dz w a h\ O
nela	n E l a
nembelela	n E m b E l E l a
nemeneme	n E m E n E m E
nemisa	n E m i s a
nemukovhani	n E m u k_> O B a n i
ner	n E r
neta	n E t_> a
neti	n E t_> i
netiweka	n E t_> i w E k_> a
netiweke	n E t_> i w E k_> E
netshedza	n E tS_h E dz a
netshedze	n E tS_h E dz E
netshedziwa	n E tS_h E dz i w a
netshedzo	n E tS_h E dz O
netshedzwa	n E tS_h E dz w a
netshedzwaho	n E tS_h E dz w a h\ O
network	n E t_h w a k_h
network	n E t_> w O r k_>
new	n E w
new	n j u
newa	n E w a
newaho	n E w a h\ O
newe	n E w E
nf	E n E f
nga	n g a
ngadzo	n g a dz O
ngae	n g a E
ngaendiuri	n g a E n d i u r i
ngafarelelakhae	n g a f a r E l E l a k_h a E
ngafhi	n g a p\ i
ngaho	n g a h\ O
ngaitwa	n g a i t_> w a
ngakhethululo	n g a k_h E t_h u l u l O
ngalavha	n g a l a B a
ngalo	n g a l O
ngamapa	n g a m a p_> a
nganea	n g a n E a
nganeapfhufhi	n g a n E a p_> p\ u p\ i
nganeapfufhi	n g a n E a p_> f u p\ i
nganga	n g a n g a
ngani	n g a n i
ngano	n g a n O
ngao	n g a O
ngaredza	n g a r E dz a
ngatsho	n g a tS_h O
ngaurali	n g a u r a l i
ngauralo	n g a u r a l O
ngauri	n g a u r i
ngavhe	n g a B E
ngavho	n g a B O
ngawo	n g a w O
ngayo	n g a j O
ngazwo	n g a zw O
ngaḽo	n g a l O
nge	n g E
ngea	n g E a
ngei	n g E i
ngeiḓoroboni	n g E i d O r O b O n i
ngeletshedzo	n g E l E tS_h E dz O
ngeno	n g E n O
ngeḓane	n g E d a n E
ngo	n g O
ngoho	n g O h\ O
ngoma	n g O m a
ngomalungundu	n g O m a l u n g u n d u
ngomu	n g O m u
ngona	n g O n a
ngonani	n g O n a n i
ngos	N g O E s
ngovhela	n g O B E l a
ngoḓaho	n g O d a h\ O
ngudo	n g u d_0Z O
ngudza	n g u dz a
nguluvha	n g u l u B a
nguluvhe	n g u l u B E
ngwaluwa	n g w a l u w a
ngwaniwapo	n g w a n i w a p_> O
nha	n a
nhani	n a n i
ni	n i
night	n a t_h
night	n i g t_>
nikhotini	n i k_h O t_> i n i
nikone	n i k_> O n E
nila	n i l a
nineteenth	n a n t_h i n f
nineteenth	n i n E t_> E E n t_h
ningo	n i n g O
ningoni	n i n g O n i
nisedzo	n i s E dz O
nivhadzo	n i B a dz O
nivho	n i B O
niwaho	n i w a h\ O
nkene	n k_> E n E
nkhumbudza	n k_h u m b u dz a
nkhumbudzelani	n k_h u m b u dz E l a n i
nkhumbulela	n k_h u m b u l E l a
nkhwala	n k_h w a l a
nkhwe	n k_h w E
nkosi	n k_> O s i
nkuku	n k_> u k_> u
nkukuwe	n k_> u k_> u w E
nls	E n a l E s
nlsa	E n a l E s E
nn	E n E n
nna	N n a
nnda	N n d a
nndwa	N n d w a
nndweleni	N n d w E l E n i
nne	N n E
nngafhaḽangafhaḽa	N n g a p\ a l a n g a p\ a l a
nngu	N n g u
nnu	N n u
nnyi	N J i
nnzhi	N n Z i
nnzhisa	N n Z i s a
nnḓ	N n d
nnḓa	N n d a
nnḓivhi	N n d i B i
nnḓu	N n d u
no	n O
nobel	n O b E l
nokisa	n O k_> i s a
nokisaho	n O k_> i s a h\ O
nombelo	n O m b E l O
nomboro	n O m b O r O
nomborwa	n O m b O r w a
nona	n O n a
nonaho	n O n a h\ O
noni	n O n i
nora	n O r a
nora	n O r E
norse	n O r s E
norse	n O s
north	n O f
north	n O r t_h
notha	n O t_h a
notsi	n O ts_> i
novels	n O v E l s
november	n O v E m b E r
nowa	n O w a
noṱhe	n O t_h E
nqf	E n k_h j u E f
nqf	n k_h f
ntakadza	n t_> a k_> a dz a
ntakadzesa	n t_> a k_> a dz E s a
ntangaho	n t_> a n g a h\ O
ntha	n t_h a
nthabalala	n t_h a b a l a l a
nthambeleni	n t_h a m b E l E n i
nthani	n t_h a n i
nthesa	n t_h E s a
nthihi	n t_h i h\ i
nthusa	n t_h u s a
nthwa	n t_h w a
ntshavheni	n tS_h a B E n i
ntshengedzeni	n tS_h E n g E dz E n i
ntshonisa	n tS_h O n i s a
ntsia	n ts_> i a
ntsundeni	n ts_> u n d E n i
ntswa	n ts_> w a
nungo	n u n g O
nuḓa	n u d a
nwa	n w a
nwaha	n w a h\ a
nwaho	n w a h\ O
nwala	n w a l a
nwalani	n w a l a n i
nwale	n w a l E
nwalisa	n w a l i s a
nwaliswaho	n w a l i sw a h\ O
nwaliwaho	n w a l i w a h\ O
nwalwaho	n w a l w a h\ O
nwalwahoni	n w a l w a h\ O n i
nwambo	n w a m b O
nwana	n w a n a
nwedzi	n w E dz i
nweledza	n w E l E dz a
nwelela	n w E l E l a
nwesa	n w E s a
nwi	n w i
nwisa	n w i s a
nwiwa	n w i w a
nyadzea	J a dz E a
nyala	J a l a
nyaluho	J a l u h\ O
nyaluso	J a l u s O
nyaluwo	J a l u w O
nyambahuvhili	J a m b a h\ u B i l i
nyambedzano	J a m b E dz a n O
nyambo	J a m b O
nyambudziwa	J a m b u dz i w a
nyamulila	J a m u l i l a
nyamulimba	J a m u l i m b a
nyamuḽanalo	J a m u l a n a l O
nyana	J a n a
nyanano	J a n a n O
nyandadzamafhungo	J a n d a dz a m a p\ u n g O
nyandano	J a n d a n O
nyangaredzi	J a n g a r E dz i
nyanyulaho	J a J u l a h\ O
nyanyule	J a J u l E
nyanyulea	J a J u l E a
nyanyulwa	J a J u l w a
nyanyuwa	J a J u w a
nyanḓadzo	J a n d a dz O
nyanḓano	J a n d a n O
nyatshavhumbwa	J a tS_h a B u m b w a
nyatshavhungwa	J a tS_h a B u n g w a
nyavha	J a B a
nyefula	J E f u l a
nyelelo	J E l E l O
nyendo	J E n d O
nyengedzedzo	J E n g E dz E dz O
nyengedzo	J E n g E dz O
nyimbo	J i m b O
nyimele	J i m E l E
nyimelo	J i m E l O
nyisedzo	J i s E dz O
nyito	J i t_> O
nymbedzano	J m b E dz a n O
nyofho	J O p\ O
nyolo	J O l O
nyonyoloso	J O J O l O s O
nyumonia	J u m O n i a
nzambo	n z a m b O
nzela	n z E l a
nzhele	n Z E l E
nzhelele	n Z E l E l E
nzhi	n Z i
nzie	n z i E
nzio	n z i O
nzudzanyo	n z u dz a J O
nzulele	n z u l E l E
nzulelele	n z u l E l E l E
nzumbululo	n z u m b u l u l O
nzunzu	n z u n z u
nzwalelo	n zw a l E l O
nzwaliso	n zw a l i s O
nzwalo	n zw a l O
nzwii	n zw i i
nzwiii	n zw i i i
nḓala	n d a l a
nḓaḓo	n d a d O
nḓevhe	n d E B E
nḓila	n d i l a
nḓilani	n d i l a n i
nḓilaḓe	n d i l a d E
nḓisedzo	n d i s E dz O
nḓivhadzo	n d i B a dz O
nḓivho	n d i B O
nḓou	n d O u
nḓowelo	n d O w E l O
nḓowenḓowe	n d O w E n d O w E
nḓowetshumo	n d O w E tS_h u m O
nḓuhu	n d u h\ u
nḓuni	n d u n i
nṋa	n n a
nṋdu	n n d_0Z u
nṋe	n n E
nṋea	n n E a
nṋgwe	n n g w E
nṋne	n n n E
nṱha	n t_h a
nṱhani	n t_h a n i
nṱhwa	n t_h w a
nṱhwamakhura	n t_h w a m a k_h u r a
nṱtha	n t_> t_h a
o	O
oa	O a
obama	O b a m a
obama	O b a m E
oda	O d_0Z a
odeaho	O d_0Z E a h\ O
odele	O d_0Z E l E
oditha	O d_0Z i t_h a
odzhi	O dz h\ i
oea	O E a
oeaho	O E a h\ O
of	O p\
of	O v
ofha	O p\ a
ofhi	O p\ i
ofhisa	O p\ i s a
ofhiwa	O p\ i w a
ofisi	O f i s i
ofisii	O f i s i i
ofisini	O f i s i n i
ogwa	O g w a
ohe	O h\ E
okaho	O k_> a h\ O
okisaho	O k_> i s a h\ O
okisidzheni	O k_> i s i dz h\ E n i
ola	O l a
old	O l d
old	O l d_0Z
olelwa	O l E l w a
olimpiki	O l i m p_> i k_> i
olingedza	O l i n g E dz a
oliwa	O l i w a
ologi	O l O g i
olwe	O l w E
olympic	E l E m p_h i k_h
oma	O m a
omaho	O m a h\ O
omba	O m b a
ombana	O m b a n a
ombedzela	O m b E dz E l a
ombedzelwa	O m b E dz E l w a
ombi	O m b i
ombo	O m b O
omelela	O m E l E l a
onasi	O n a s i
onda	O n d a
one	O n E
one	w a n
onesana	O n E s a n a
ongolowa	O n g O l O w a
oni	O n i
online	O n l a n
online	O n l i n E
onoyo	O n O j O
onoyu	O n O j u
onyolosa	O J O l O s a
onyolowa	O J O l O w a
open	O p_> E n
open	O p_h E n
orala	O r a l a
orange	O r a n g E
orange	O r i n d_0Z
organization	O g E n a z E s E n
organization	O r g a n i z a t_> i O n
organizations	O g E n a z E s E n z
organizations	O r g a n i z a t_> i O n s
ori	O r i
oriental	O r i E n t_> a l
oriental	O r i E n t_h E l
original	E r i d_0Z E n E l
original	O r i g i n a l
orobo	O r O b O
orthodox	O f E d O k_h s
orthodox	O r t_h O d_0Z O x
orwi	O r w i
osama	O s a m a
osteoarithritis	O s t_> E O a r i t_h r i t_> i s
othari	O t_h a r i
othe	O t_h E
othomethikhi	O t_h O m E t_h i k_h i
ou	O u
ovala	O v a l a
overseas	O v E r s E a s
overseas	O v E s i z
owa	O w a
owedzo	O w E dz O
oweleaho	O w E l E a h\ O
oḽi	O l i
oḽimpiki	O l i m p_> i k_> i
oṱhe	O t_h E
p	p_h i
pa	p_> a
pa	p_h a
paa	p_> a a
pacific	p_h E s E f i k_h
packers	p_h a k_h E z
paia	p_> a i a
pakulule	p_> a k_> u l u l E
pakwa	p_> a k_> w a
palate	p_> a l a t_> E
palate	p_h E l E t_h
palestinian	p_> a l E s t_> i n i a n
palestinian	p_h a l E s t_h i n E n
pama	p_> a m a
pambusa	p_> a m b u s a
pandamedza	p_> a n d a m E dz a
pandela	p_> a n d E l a
pandeliswa	p_> a n d E l i sw a
pandelwa	p_> a n d E l w a
pangula	p_> a n g u l a
pani	p_> a n i
pansalb	p_> a n s a l b
panḓa	p_> a n d a
paper	p_> a p_> E r
paper	p_h E p_h E r
park	p_> a r k_>
park	p_h a k_h
parole	p_> a r O l E
parole	p_h E r O l
parties	p_> a r t_> i E s
parties	p_h a t_h i z
party	p_> a r t_h
party	p_h a t_h i
paulo	p_> a u l O
paulo	p_h O j l O
paye	p_> a j E
pct	p_h i s i t_h i
pct	p_h k_h t_h
pdas	p_> i d i E s
pdf	p_> d_0Z p\
pdf	p_h i d i E f
peace	p_h i s
peama	p_> E a m a
pele	p_> E l E
pembelela	p_> E m b E l E l a
pembelelwe	p_> E m b E l E l w E
penga	p_> E n g a
peni	p_> E n i
penya	p_> E J a
penyelela	p_> E J E l E l a
people	p_> E O p_> l E
people	p_h i p_h E l
peppers	p_> E p_> p_> E r s
peppers	p_h E p_h E z
personnel	p_> E r s O n n E l
personnel	p_h a s E n E l
persons	p_> E r s O n s
persons	p_h a s E n z
peta	p_> E t_> a
peter	p_> E t_> E r
peter	p_h i t_h E r
pfa	p_> f a
pfadzaho	p_> f a dz a h\ O
pfala	p_> f a l a
pfalaho	p_> f a l a h\ O
pfale	p_> f a l E
pfana	p_> f a n a
pfanelo	p_> f a n E l O
pfani	p_> f a n i
pfaniwa	p_> f a n i w a
pfano	p_> f a n O
pfanywa	p_> f a J w a
pfareledzwa	p_> f a r E l E dz w a
pfarelo	p_> f a r E l O
pfe	p_> f E
pfela	p_> f E l a
pfesesa	p_> f E s E s a
pfesesana	p_> f E s E s a n a
pfesese	p_> f E s E s E
pfesesea	p_> f E s E s E a
pfeseswa	p_> f E s E sw a
pfi	p_> f i
pfiriri	p_> f i r i r i
pfisa	p_> f i s a
pfisaho	p_> f i s a h\ O
pfiswa	p_> f i sw a
pfiwa	p_> f i w a
pfma	p_h i E f E m E
pfudzungule	p_> f u dz u n g u l E
pfufhi	p_> f u p\ i
pfufhifhadza	p_> f u p\ i p\ a dz a
pfufho	p_> f u p\ O
pfuka	p_> f u k_> a
pfukaho	p_> f u k_> a h\ O
pfuke	p_> f u k_> E
pfukela	p_> f u k_> E l a
pfukhela	p_> f u k_h E l a
pfukhisa	p_> f u k_h i s a
pfukhwa	p_> f u k_h w a
pfukisa	p_> f u k_> i s a
pfukisela	p_> f u k_> i s E l a
pfukiwa	p_> f u k_> i w a
pfukwa	p_> f u k_> w a
pfulo	p_> f u l O
pfuloni	p_> f u l O n i
pfulusa	p_> f u l u s a
pfuluswa	p_> f u l u sw a
pfulutshelaho	p_> f u l u tS_h E l a h\ O
pfuma	p_> f u m a
pfumbudza	p_> f u m b u dz a
pfumbudziwa	p_> f u m b u dz i w a
pfumbula	p_> f u m b u l a
pfumedzana	p_> f u m E dz a n a
pfunzo	p_> f u n z O
pfushi	p_> f u S i
phaaladza	p_h a a l a dz a
phaan	p_h a a n
phabu	p_h a b u
phabulishiwaho	p_h a b u l i S i w a h\ O
phadaladza	p_h a d_0Z a l a dz a
phadaladzwa	p_h a d_0Z a l a dz w a
phadalala	p_h a d_0Z a l a l a
phafamende	p_h a f a m E n d E
phaga	p_h a g a
phahwe	p_h a h\ w E
phaini	p_h a i n i
phaiphi	p_h a i p_h i
phakha	p_h a k_h a
phakhethe	p_h a k_h E t_h E
phala	p_h a l a
phalalana	p_h a l a l a n a
phalamende	p_h a l a m E n d E
phalamennde	p_h a l a m E n n d E
phalammennde	p_h a l a m E n n d E
phalaphala	p_h a l a p_h a l a
phambana	p_h a m b a n a
phambano	p_h a m b a n O
phamu	p_h a m u
phana	p_h a n a
phand	p_h a n d
phanda	p_h a n d a
phando	p_h a n d O
phane	p_h a n E
phanele	p_h a n E l E
phanga	p_h a n g a
phangami	p_h a n g a m i
phanḓa	p_h a n d a
phapha	p_h a p_h a
phaphulana	p_h a p_h u l a n a
phara	p_h a r a
pharafeni	p_h a r a f E n i
pharou	p_h a r O u
pharuwa	p_h a r u w a
pharuwaho	p_h a r u w a h\ O
phasa	p_h a s a
phasaho	p_h a s a h\ O
phasipoto	p_h a s i p_> O t_> O
phasisa	p_h a s i s a
phasiwede	p_h a s i w E d_0Z E
phathini	p_h a t_h i n i
phaḓaladza	p_h a d a l a dz a
phaḓaladzo	p_h a d a l a dz O
phaḓaladzwa	p_h a d a l a dz w a
phaḓalala	p_h a d a l a l a
phaḓalazwa	p_h a d a l a zw a
phaḽamennde	p_h a l a m E n n d E
pheirolo	p_h E i r O l O
pheivimennde	p_h E i v i m E n n d E
phendelo	p_h E n d E l O
phephela	p_h E p_h E l a
phepho	p_h E p_h O
phesenthe	p_h E s E n t_h E
phesheni	p_h E S E n i
phethishini	p_h E t_h i S i n i
phiano	p_h i a n O
phimo	p_h i m O
phindulo	p_h i n d u l O
phiphiḓi	p_h i p_h i d i
phiriphiri	p_h i r i p_h i r i
phirisela	p_h i r i s E l a
phiriso	p_h i r i s O
phoisi	p_h O i s i
pholisa	p_h O l i s a
pholishi	p_h O l i S i
pholisi	p_h O l i s i
phondi	p_h O n d i
phophi	p_h O p_h i
phoromotha	p_h O r O m O t_h a
phosho	p_h O S O
phosphorus	f O s f E r E s
phosphorus	p_h O s p_h O r u s
phoḽisi	p_h O l i s i
phukha	p_h u k_h a
phule	p_h u l E
phulea	p_h u l E a
phuleithi	p_h u l E i t_h i
phulethi	p_h u l E t_h i
phuli	p_h u l i
phulisa	p_h u l i s a
phulusa	p_h u l u s a
phumulea	p_h u m u l E a
phungo	p_h u n g O
phungommbi	p_h u n g O m b i
phungudzo	p_h u n g u dz O
phuphuledza	p_h u p_h u l E dz a
phuphuzika	p_h u p_h u z i k_> a
phuraimari	p_h u r a i m a r i
phuraivele	p_h u r a i v E l E
phuraivete	p_h u r a i v E t_> E
phuraivethe	p_h u r a i v E t_h E
phuresidennde	p_h u r E s i d_0Z E n n d E
phurinthiwa	p_h u r i n t_h i w a
phurofaili	p_h u r O f a i l i
phurofesheni	p_h u r O f E S E n i
phurofeshinala	p_h u r O f E S i n a l a
phurofeshinaḽa	p_h u r O f E S i n a l a
phurofiti	p_h u r O f i t_> i
phurogireme	p_h u r O g i r E m E
phuromota	p_h u r O m O t_> a
phuromotha	p_h u r O m O t_h a
phuromothiwa	p_h u r O m O t_h i w a
phurophoziwaho	p_h u r O p_h O z i w a h\ O
phurosesa	p_h u r O s E s a
phurosesiwa	p_h u r O s E s i w a
phurotheini	p_h u r O t_h E i n i
phurovidende	p_h u r O v i d_0Z E n d E
phurovintsi	p_h u r O v i n ts_> i
physics	f i z i k_h s
phytosamitary	p_h j t_> O s a m i t_> a r j
phytosanitary	p_h j t_> O s a n i t_> a r j
piere	p_> i E r E
pii	p_> i i
pikisa	p_> i k_> i s a
pikisana	p_> i k_> i s a n a
pikisanaho	p_> i k_> i s a n a h\ O
pilela	p_> i l E l a
pima	p_> i m a
pindulela	p_> i n d u l E l a
pindulelwa	p_> i n d u l E l w a
pitirosi	p_> i t_> i r O s i
pitori	p_> i t_> O r i
plan	p_h l a n
plan	p_> l a n
planned	p_h l a n d
planned	p_> l a n n E d_0Z
please	p_h l i z
please	p_> l E a s E
pmb	p_h i E m b i
poidza	p_> O i dz a
polish	p_h O l i s
polish	p_> O l i S
political	p_h E l E t_h i k_h E l
polotiki	p_> O l O t_> i k_> i
pomoka	p_> O m O k_> a
posa	p_> O s a
pose	p_h O z
pose	p_> O s E
posikaraṱa	p_> O s i k_> a r a t_> a
posofisi	p_> O s O f i s i
posoni	p_> O s O n i
postal	p_h O s t_h E l
postal	p_> O s t_> a l
poswa	p_> O sw a
poswo	p_> O sw O
poswoni	p_> O sw O n i
potwa	p_> O t_> w a
poḽotiki	p_> O l O t_> i k_> i
president	p_h r E z E d E n t_h
president	p_> r E s i d_0Z E n t_>
presidential	p_h r E z i d E n s E l
presidential	p_> r E s i d_0Z E n t_> i a l
press	p_h r E s
press	p_> r E s s
pretoria	p_h r i t_h O r E
pretoria	p_> r E t_> O r i a
priest	p_h r i s t_h
priest	p_> r i E s t_>
prime	p_h r a m
prime	p_> r i m E
prize	p_h r a z
prize	p_> r i z E
pro	p_h r O
pro	p_> r O
probability	p_h r O b E b E l E t_h i
probability	p_> r O b a b i l i t_h
processing	p_h r O s E s i N
product	p_h r O d a k_h t_h
professional	p_h r E f E s E n E l
professional	p_> r O f E s s i O n a l
property	p_h r O p_h E t_h i
property	p_> r O p_> E r t_h
protocol	p_h r O t_h E k_h O l
protocols	p_h r O t_h E k_h O l z
provincial	p_h r E v i n s E l
psychiatric	s a k_h i a t_h r i k_h
pu	p_> u
public	p_h a b l i k_h
pulana	p_> u l a n a
pulane	p_> u l a n E
pulani	p_> u l a n i
pulaniwaho	p_> u l a n i w a h\ O
pulatifomo	p_> u l a t_> i f O m O
puloto	p_> u l O t_> O
puḽasitiki	p_> u l a s i t_> i k_> i
puṱedza	p_> u t_> E dz a
pwanyeledza	p_> w a J E l E dz a
pwasha	p_> w a S a
pwashekana	p_> w a S E k_> a n a
pwashekanaho	p_> w a S E k_> a n a h\ O
quantum	k_h w O n t_h E m
r	a r
ra	r a
rabota	r a b O t_> a
rabulasi	r a b u l a s i
radio	r a d_0Z i O
radio	r E d E E
rafha	r a p\ a
ragabi	r a g a b i
raha	r a h\ a
railway	r a i l w a j
railway	r E l w E
raisi	r a i s i
rakhemisi	r a k_h E m i s i
rali	r a l i
raliho	r a l i h\ O
ralo	r a l O
raloho	r a l O h\ O
raluswielo	r a l u sw i E l O
ramabindu	r a m a b i n d u
ramabotha	r a m a b O t_h a
ramabulana	r a m a b u l a n a
ramaphosa	r a m a p_h O s a
ramaremisa	r a m a r E m i s a
ramasunzi	r a m a s u n z i
ramavhoya	r a m a B O j a
ramba	r a m b a
rambalala	r a m b a l a l a
rambau	r a m b a u
rambiwaho	r a m b i w a h\ O
rambo	r a m b O
rambuḓa	r a m b u d a
rammbuda	r a m b u d_0Z a
rammbuḓa	r a m b u d a
rammpofu	r a m p_> O f u
ramulayo	r a m u l a j O
randelwaho	r a n d E l w a h\ O
ranga	r a n g a
rangaphana	r a n g a p_h a n a
rankhododo	r a n k_h O d_0Z O d_0Z O
rantete	r a n t_> E t_> E
ranḓavhula	r a n d a B u l a
raphulu	r a p_h u l u
rasaintsi	r a s a i n ts_> i
rasimphi	r a s i m p_h i
rasithi	r a s i t_h i
rasiti	r a s i t_> i
rate	r a t_> E
rate	r E t_h
rathekiniki	r a t_h E k_> i n i k_> i
rathi	r a t_h i
rathisela	r a t_h i s E l a
rathiselaho	r a t_h i s E l a h\ O
rathiseli	r a t_h i s E l i
rathiyaya	r a t_h i j a j a
ratombo	r a t_> O m b O
ravhududo	r a B u d_0Z u d_0Z O
ravhura	r a B u r a
ravhuthata	r a B u t_h a t_> a
ravhuthatha	r a B u t_h a t_h a
ray	r a j
ray	r E
re	r E
re	r i
rea	r E a
record	r E k_h O d
red	r E d
red	r E d_0Z
redzhisi	r E dz h\ i s i
redzhisiariswa	r E dz h\ i s i a r i sw a
redzhisita	r E dz h\ i s i t_> a
redzhisitara	r E dz h\ i s i t_> a r a
redzhisiṱara	r E dz h\ i s i t_> a r a
redzhisiṱarisiwaho	r E dz h\ i s i t_> a r i s i w a h\ O
redzhisṱara	r E dz h\ i s t_> a r a
redzisiṱariwa	r E dz i s i t_> a r i w a
referentsi	r E f E r E n ts_> i
reila	r E i l a
rekanya	r E k_> a J a
rekhithengele	r E k_h i t_h E n g E l E
rekhoda	r E k_h O d_0Z a
rekhodiwa	r E k_h O d_0Z i w a
rekhodiwaho	r E k_h O d_0Z i w a h\ O
rekhodo	r E k_h O d_0Z O
rekhodwa	r E k_h O d w a
release	r E l E a s E
release	r i l i s
religious	r E l i g i O u s
religious	r i l i d_0Z E s
rembuluwa	r E m b u l u w a
remiwe	r E m i w E
renga	r E n g a
renge	r E n g E
rengele	r E n g E l E
rengenyela	r E n g E J E l a
rengisa	r E n g i s a
rengisaho	r E n g i s a h\ O
rengise	r E n g i s E
rengisela	r E n g i s E l a
rengiselwa	r E n g i s E l w a
rengisiwa	r E n g i s i w a
rengiswa	r E n g i sw a
rengiswaho	r E n g i sw a h\ O
rengiswi	r E n g i sw i
rengiwa	r E n g i w a
rengiwe	r E n g i w E
rengwa	r E n g w a
rengwaho	r E n g w a h\ O
rennda	r E n n d a
rennde	r E n n d E
republic	r i p_h a b l i k_h
republican	r i p_h a b l i k_h E n
rera	r E r a
rere	r E r E
reserve	r E s E r v E
reserve	r i z a v
reshana	r E S a n a
reḓiwa	r E d i w a
ri	r i
ridzeve	r i dz E v E
rights	r a t_h s
rights	r i g ts_>
rine	r i n E
riotshe	r i O tS_h E
riphabuliki	r i p_h a b u l i k_> i
riphabuḽiki	r i p_h a b u l i k_> i
ripoto	r i p_> O t_> O
risetshe	r i s E tS_h E
risithi	r i s i t_h i
ritha	r i t_h a
riṋe	r i n E
ro	r O
robben	r O b b E n
rofhiwa	r O p\ i w a
rogolelana	r O g O l E l a n a
rolivhuwa	r O l i B u w a
rolivhuwan	r O l i B u w a n
rolo	r O l O
roman	r O m a n
roman	r O m E n
rothe	r O t_h E
rothola	r O t_h O l a
royal	r O E l
royal	r O j a l
royals	r O E l z
royals	r O j a l s
roṱhe	r O t_h E
rubisa	r u b i s a
rubriki	r u b r i k_> i
rudzani	r u dz a n i
rugby	r a g b i
rugby	r u g b j
rulea	r u l E a
ruma	r u m a
rumela	r u m E l a
rumelaho	r u m E l a h\ O
rumelani	r u m E l a n i
rumele	r u m E l E
rumelwa	r u m E l w a
rumelwaho	r u m E l w a h\ O
rumelwe	r u m E l w E
rumiwe	r u m i w E
rumu	r u m u
rumuni	r u m u n i
runga	r u n g a
russian	r a s E n
russian	r u s s i a n
ruṅwa	r u n w a
rwa	r w a
rwaho	r w a h\ O
rwela	r w E l a
rwelwa	r w E l w a
rwisa	r w i s a
rwiwa	r w i w a
rzwo	a r z w O
sa	s a
saathu	s a a t_h u
sabc	E s E b i s i
sabc	s a b k_h
sabinete	s a b i n E t_> E
sacga	s a k_h g E
sadc	E s E d i s i
sagani	s a g a n i
sagnc	E s E d_0Z i E n s i
sagnc	s a g N k_h
sagole	s a g O l E
saina	s a i n a
sainaho	s a i n a h\ O
sainelwa	s a i n E l w a
sainiwa	s a i n i w a
sainiwaho	s a i n i w a h\ O
saints	s a i n ts_>
saints	s E n t_h s
saintsi	s a i n ts_> i
sainwa	s a i n w a
sainwaho	s a i n w a h\ O
sainwe	s a i n w E
saizi	s a i z i
saizwi	s a i zw i
sakha	s a k_h a
sala	s a l a
salafhi	s a l a p\ i
salaho	s a l a h\ O
salani	s a l a n i
sale	s a l E
sale	s E l
salela	s a l E l a
salelaho	s a l E l a h\ O
sales	s a l E s
sales	s E l z
salt	s a l t_>
salt	s O l t_h
salwa	s a l w a
sam	s a m
samari	s a m a r i
samba	s a m b a
samba	s a m b E
sambi	s a m b i
sambulu	s a m b u l u
sambuluswa	s a m b u l u sw a
samithi	s a m i t_h i
samsa	s a m s a
samuele	s a m u E l E
samusi	s a m u s i
sandf	E s E E n d i E f
sandf	s a n d p\
sandra	s a n d r a
sandra	s a n d r E
sankambe	s a n k_> a m b E
saps	s a p_h s
saps	s a p_> s
sapu	s a p_> u
sapulasi	s a p_> u l a s i
sara	s a r a
sara	s a r E
sars	s a r s
sasa	s a s a
sasaladza	s a s a l a dz a
sasaladzwa	s a s a l a dz w a
sasc	E s E E s s i
sasc	s a s k_h
satsha	s a tS_h a
satshipida	s a tS_h i p_> i d_0Z a
sax	s a k_h s
sax	s a x
saṱhane	s a t_h a n E
science	s a E n s
scrolls	s k_h r O l z
sdivhadzo	s d_0Z i B a dz O
sea	s E a
sea	s i
search	s a tS_h
second	s E k_h E n d
secondary	s E k_h E n d r i
security	s E k_h j O r E t_h i
sedza	s E dz a
sedzana	s E dz a n a
sedze	s E dz E
sedzeswa	s E dz E sw a
sedzeswaho	s E dz E sw a h\ O
sedzheni	s E dz h\ E n i
sedzi	s E dz i
sedziwa	s E dz i w a
sedziwi	s E dz i w i
sedzulusa	s E dz u l u s a
sedzuluse	s E dz u l u s E
sedzulusea	s E dz u l u s E a
sedzuluswa	s E dz u l u sw a
sedzuluswaho	s E dz u l u sw a h\ O
sedzwa	s E dz w a
sedzwe	s E dz w E
sedzwi	s E dz w i
seed	s E E d_0Z
seed	s i d
segereṱe	s E g E r E t_> E
sei	s E i
sekhitha	s E k_h i t_h a
sekhithara	s E k_h i t_h a r a
sekitha	s E k_> i t_h a
sekithara	s E k_> i t_h a r a
sekitshara	s E k_> i tS_h a r a
sekondari	s E k_> O n d a r i
sela	s E l a
seli	s E l i
sema	s E m a
semana	s E m a n a
semekanya	s E m E k_> a J a
semenndeni	s E m E n n d E n i
semiwa	s E m i w a
senate	s E n a t_> E
senate	s E n E t_h
senators	s E n a t_> O r s
senators	s E n E t_h E z
sendedza	s E n d E dz a
sendela	s E n d E l a
senenga	s E n E n g a
senga	s E n g a
sengenedza	s E n g E n E dz a
sengi	s E n g i
sengisa	s E n g i s a
sengisi	s E n g i s i
sengisiwa	s E n g i s i w a
sengiswa	s E n g i sw a
sengiwa	s E n g i w a
sengulusa	s E n g u l u s a
sengulusiwe	s E n g u l u s i w E
senguluswa	s E n g u l u sw a
sengwa	s E n g w a
senthara	s E n t_h a r a
sentharani	s E n t_h a r a n i
sentshari	s E n tS_h a r i
sequence	s i k_h w E n s
sereni	s E r E n i
series	s E r i E s
series	s E r i z
service	s a v E s
setha	s E t_h a
sethe	s E t_h E
sethifaiwa	s E t_h i f a i w a
sethifaiwaho	s E t_h i f a i w a h\ O
setsha	s E tS_h a
setshelela	s E tS_h E l E l a
setshiwa	s E tS_h i w a
sevenda	s E v E n d a
sevhedza	s E B E dz a
sevhela	s E B E l a
seḽi	s E l i
seṅwa	s E n w a
shaea	S a E a
shaedza	S a E dz a
shaeya	S a E j a
shah	s a
shah	S a h\
shaka	S a k_> a
shakuliswa	S a k_> u l i sw a
shambela	S a m b E l a
shambo	S a m b O
shanduka	S a n d u k_> a
shandukani	S a n d u k_> a n i
shandukela	S a n d u k_> E l a
shandukisa	S a n d u k_> i s a
shandukisaho	S a n d u k_> i s a h\ O
shandukise	S a n d u k_> i s E
shandukiseaho	S a n d u k_> i s E a h\ O
shandukiswa	S a n d u k_> i sw a
shandula	S a n d u l a
shango	S a n g O
shangoni	S a n g O n i
shavha	S a B a
shavhe	S a B E
shavhedza	S a B E dz a
shavhela	S a B E l a
shawara	S a w a r a
shaya	S a j a
shayaho	S a j a h\ O
shayandima	S a j a n d i m a
shedulu	S E d_0Z u l u
shela	S E l a
shelaho	S E l a h\ O
shele	S E l E
sheledza	S E l E dz a
shelelwa	S E l E l w a
shelesa	S E l E s a
shelwa	S E l w a
shelwaho	S E l w a h\ O
shengedza	S E n g E dz a
shengedzwa	S E n g E dz w a
sheḓo	S E d O
shi	E s E tS_h a
shi	S i
shiashia	S i a S i a
shidondho	S i d_0Z O n d O
shimbasala	S i m b a s a l a
shingizhela	S i n g i Z E l a
shishi	S i S i
shoma	S O m a
shomedza	S O m E dz a
shomedzwa	S O m E dz w a
shona	S O n a
shoni	S O n i
shonisa	S O n i s a
shonisaho	S O n i s a h\ O
shoniswa	S O n i sw a
shu	S u
shulula	S u l u l a
shulule	S u l u l E
shuma	S u m a
shumaho	S u m a h\ O
shumana	S u m a n a
shumanaho	S u m a n a h\ O
shumane	S u m a n E
shumaniwa	S u m a n i w a
shumanwa	S u m a n w a
shumba	S u m b a
shume	S u m E
shumela	S u m E l a
shumele	S u m E l E
shumeli	S u m E l i
shumelwa	S u m E l w a
shumesa	S u m E s a
shumese	S u m E s E
shumi	S u m i
shumiho	S u m i h\ O
shumisa	S u m i s a
shumisaho	S u m i s a h\ O
shumisana	S u m i s a n a
shumisanaho	S u m i s a n a h\ O
shumisani	S u m i s a n i
shumisaniwa	S u m i s a n i w a
shumisanwa	S u m i s a n w a
shumise	S u m i s E
shumisea	S u m i s E a
shumiseaho	S u m i s E a h\ O
shumiselwa	S u m i s E l w a
shumiseni	S u m i s E n i
shumisesa	S u m i s E s a
shumiseswa	S u m i s E sw a
shumisiwa	S u m i s i w a
shumisiwaho	S u m i s i w a h\ O
shumiswa	S u m i sw a
shumiswaho	S u m i sw a h\ O
shumiswe	S u m i sw E
shumiwa	S u m i w a
shumiwaho	S u m i w a h\ O
shumiwe	S u m i w E
shundunthule	S u n d u n t_h u l E
shunwa	S u n w a
shushaho	S u S a h\ O
shushedza	S u S E dz a
shushedzwa	S u S E dz w a
shuvhuru	S u B u r u
si	E s a
si	s i
sia	s i a
siaho	s i a h\ O
sialala	s i a l a l a
siangane	s i a n g a n E
siani	s i a n i
siatari	s i a t_> a r i
siaṱari	s i a t_> a r i
sibadela	s i b a d_0Z E l a
sidimela	s i d_0Z i m E l a
sie	s i E
siedza	s i E dz a
siedze	s i E dz E
siela	s i E l a
sielisana	s i E l i s a n a
sielwa	s i E l w a
signal	s i g n a l
signal	s i g n E l
siho	s i h\ O
siiwa	s i i w a
sika	s i k_> a
sikaho	s i k_> a h\ O
sikelela	s i k_> E l E l a
sikiwa	s i k_> i w a
sikwa	s i k_> w a
sikwe	s i k_> w E
silahapani	s i l a h\ a p_> a n i
sima	s i m a
simesa	s i m E s a
simon	s a m E n
simon	s i m O n
simunye	s i m u J E
simuwa	s i m u w a
sin	s E n
sin	s i n
sina	s i n a
singa	s i n g a
singo	s i n g O
sini	s i n i
sinthumule	s i n t_h u m u l E
sinvuwa	s i n v u w a
sinyalala	s i J a l a l a
sinyukana	s i J u k_> a n a
sinyusa	s i J u s a
sinyuwa	s i J u w a
sinyuwaho	s i J u w a h\ O
siphegana	s i p_h E g a n a
sisieme	s i s i E m E
sisiteme	s i s i t_> E m E
sisitemetiki	s i s i t_> E m E t_> i k_> i
sisiṱa	s i s i t_> a
sisiṱeme	s i s i t_> E m E
sisteme	s i s t_> E m E
site	s a t_h
site	s i t_> E
sithi	s i t_h i
sivhara	s i B a r a
sivhe	s i B E
siviki	s i v i k_> i
siwka	s i w k_> a
siya	s i j a
siḽomu	s i l O m u
smart	s m a r t_>
smart	s m a t_h
so	s O
social	s O s E l
socialist	s O s E l E s t_h
sokou	s O k_> O u
sola	s O l a
songo	s O n g O
sophia	s E f a
sophia	s O p_h i a
sori	s O r i
sosaithi	s O s a i t_h i
source	s O s
south	s a f
south	s O u t_h
southeast	s a f i s t_h
southeast	s O u t_h E a s t_>
southern	s a d E n
southern	s O u t_h E r n
sox	s O k_h s
sox	s O x
space	s p_h E s
spii	s p_> i i
sports	s p_h O t_h s
sports	s p_> O r ts_>
sps	E s p_h i E s
srsa	E s a r E s E
ssp	E s E s p_h i
standard	s t_> a n d a r d_0Z
standard	s t_h a n d E d
stars	s t_> a r s
stars	s t_h a z
state	s t_> a t_> E
state	s t_h E t_h
states	s t_> a t_> E s
states	s t_h E t_h s
stock	s t_h O k_h
sudzulusa	s u dz u l u s a
sudzuluswa	s u dz u l u sw a
sudzuluwe	s u dz u l u w E
suffrage	s a f r i d_0Z
suffrage	s u p\ p\ r a g E
suite	s u i t_> E
suite	s w i t_h
sukela	s u k_> E l a
suko	s u k_> O
sukumedza	s u k_> u m E dz a
sukumedzela	s u k_> u m E dz E l a
suma	s u m a
sumba	s u m b a
sumbaho	s u m b a h\ O
sumbe	s u m b E
sumbedza	s u m b E dz a
sumbedzaho	s u m b E dz a h\ O
sumbedzani	s u m b E dz a n i
sumbedze	s u m b E dz E
sumbedzesa	s u m b E dz E s a
sumbedzi	s u m b E dz i
sumbedzisa	s u m b E dz i s a
sumbedzisaho	s u m b E dz i s a h\ O
sumbedziswa	s u m b E dz i sw a
sumbedzwa	s u m b E dz w a
sumbedzwaho	s u m b E dz w a h\ O
sun	s a n
sun	s u n
suphamakete	s u p_h a m a k_> E t_> E
supply	s E p_h l a
supply	s u p_> p_> l j
support	s E p_h O t_h
support	s u p_> p_> O r t_>
supreme	s u p_h r i m
supreme	s u p_> r E m E
sutuka	s u t_> u k_> a
suvha	s u B a
suvhani	s u B a n i
swa	sw a
swaiwa	sw a i w a
swaswara	sw a sw a r a
swaya	sw a j a
swaye	sw a j E
swaṱaho	sw a t_> a h\ O
swe	sw E
swedish	sw E d_0Z i S
swedish	s w i d i s
swethani	sw E t_h a n i
swi	sw i
swiela	sw i E l a
swifhadza	sw i p\ a dz a
swifhadzwaho	sw i p\ a dz w a h\ O
swifhala	sw i p\ a l a
swigiri	sw i g i r i
swika	sw i k_> a
swikaho	sw i k_> a h\ O
swikahune	sw i k_> a h\ u n E
swike	sw i k_> E
swikela	sw i k_> E l a
swikelea	sw i k_> E l E a
swikelela	sw i k_> E l E l a
swikelele	sw i k_> E l E l E
swikelelea	sw i k_> E l E l E a
swikelelwa	sw i k_> E l E l w a
swikelelwe	sw i k_> E l E l w E
swikisa	sw i k_> i s a
swikise	sw i k_> i s E
swikiswa	sw i k_> i sw a
swikiswaho	sw i k_> i sw a h\ O
swina	sw i n a
swiri	sw i r i
swishumiswa	sw i S u m i sw a
swiswi	sw i sw i
swiswini	sw i sw i n i
swondaha	sw O n d a h\ a
system	s E s t_h E m
system	s j s t_> E m
t	t_h i
ta	t_> a
ta	t_h a
tahe	t_> a h\ E
tahisa	t_> a h\ i s a
tahulela	t_> a h\ u l E l a
takadza	t_> a k_> a dz a
takadzaho	t_> a k_> a dz a h\ O
takadzi	t_> a k_> a dz i
takadzwa	t_> a k_> a dz w a
takala	t_> a k_> a l a
takalaho	t_> a k_> a l a h\ O
takalani	t_> a k_> a l a n i
takale	t_> a k_> a l E
takalea	t_> a k_> a l E a
takalela	t_> a k_> a l E l a
takaleli	t_> a k_> a l E l i
takalelwa	t_> a k_> a l E l w a
takali	t_> a k_> a l i
takalwa	t_> a k_> a l w a
takula	t_> a k_> u l a
takusa	t_> a k_> u s a
takuwa	t_> a k_> u w a
takuwani	t_> a k_> u w a n i
takuwe	t_> a k_> u w E
talana	t_> a l a n a
talele	t_> a l E l E
talelwaho	t_> a l E l w a h\ O
talula	t_> a l u l a
talutshedza	t_> a l u tS_h E dz a
talutshedzani	t_> a l u tS_h E dz a n i
talutshedze	t_> a l u tS_h E dz E
talutshedzwa	t_> a l u tS_h E dz w a
talutshhedza	t_> a l u tS_h E dz a
tama	t_> a m a
tamaho	t_> a m a h\ O
tamba	t_> a m b a
tambea	t_> a m b E a
tambela	t_> a m b E l a
tambelwa	t_> a m b E l w a
tambi	t_> a m b i
tambisa	t_> a m b i s a
tambiwa	t_> a m b i w a
tambudza	t_> a m b u dz a
tambudziwa	t_> a m b u dz i w a
tambudzwa	t_> a m b u dz w a
tambudzwaho	t_> a m b u dz w a h\ O
tambula	t_> a m b u l a
tambulesa	t_> a m b u l E s a
tame	t_> a m E
tame	t_h E m
tamela	t_> a m E l a
tami	t_> a m i
tamisa	t_> a m i s a
tamiwa	t_> a m i w a
tampa	t_> a m p_> a
tampa	t_h a m p_h E
tamu	t_> a m u
tanda	t_> a n d a
tandavhudza	t_> a n d a B u dz a
tandavhudzwa	t_> a n d a B u dz w a
tandavhuwa	t_> a n d a B u w a
tandavhuwaho	t_> a n d a B u w a h\ O
tandulula	t_> a n d u l u l a
tandululani	t_> a n d u l u l a n i
tandulule	t_> a n d u l u l E
tandululwa	t_> a n d u l u l w a
tandwi	t_> a n d w i
tangaho	t_> a n g a h\ O
tangana	t_> a n g a n a
tanganedza	t_> a n g a n E dz a
tanganedze	t_> a n g a n E dz E
tanganedzeaho	t_> a n g a n E dz E a h\ O
tanganedzee	t_> a n g a n E dz E E
tanganedzeiho	t_> a n g a n E dz E i h\ O
tanganedzwa	t_> a n g a n E dz w a
tanganedzwaho	t_> a n g a n E dz w a h\ O
tanganedzwe	t_> a n g a n E dz w E
tanganelaho	t_> a n g a n E l a h\ O
tanganelana	t_> a n g a n E l a n a
tanganelanaho	t_> a n g a n E l a n a h\ O
tanganya	t_> a n g a J a
tanganyisiwaho	t_> a n g a J i s i w a h\ O
tanganyiswa	t_> a n g a J i sw a
tanganyiswaho	t_> a n g a J i sw a h\ O
tanganywa	t_> a n g a J w a
tanwi	t_> a n w i
tanzwe	t_> a n zw E
tapa	t_> a p_> a
tape	t_> a p_> E
tape	t_h E p_h
tara	t_> a r a
tata	t_> a t_> a
tati	t_> a t_> i
tatisana	t_> a t_> i s a n a
tavha	t_> a B a
tavhanya	t_> a B a J a
tavhanyedziswa	t_> a B a J E dz i sw a
tavhanyisa	t_> a B a J i s a
tea	t_> E a
tea	t_h i
teaho	t_> E a h\ O
team	t_> E a m
team	t_h i m
teams	t_> E a m s
teams	t_h i m z
teau	t_> E a u
teavhedzwa	t_> E a B E dz w a
tei	t_> E i
teketelwa	t_> E k_> E t_> E l w a
tekhinikha	t_> E k_h i n i k_h a
tenda	t_> E n d a
tendai	t_> E n d a i
tende	t_> E n d E
tendela	t_> E n d E l a
tendelaho	t_> E n d E l a h\ O
tendelana	t_> E n d E l a n a
tendelani	t_> E n d E l a n i
tendelaniwa	t_> E n d E l a n i w a
tendelanwaho	t_> E n d E l a n w a h\ O
tendele	t_> E n d E l E
tendelela	t_> E n d E l E l a
tendeli	t_> E n d E l i
tendelwa	t_> E n d E l w a
tendelwaho	t_> E n d E l w a h\ O
tendelwe	t_> E n d E l w E
tendelwi	t_> E n d E l w i
tendi	t_> E n d i
tendisea	t_> E n d i s E a
tendiwa	t_> E n d i w a
territory	t_> E r r i t_> O r j
territory	t_h E r i t_h r i
tertiary	t_> E r t_> i a r j
tertiary	t_h a s E r i
testament	t_> E s t_> a m E n t_>
testament	t_h E s t_h E m E n t_h
tevhedza	t_> E B E dz a
tevhedze	t_> E B E dz E
tevhedzela	t_> E B E dz E l a
tevhedzele	t_> E B E dz E l E
tevhedzelwa	t_> E B E dz E l w a
tevhedzwa	t_> E B E dz w a
tevhedzwe	t_> E B E dz w E
tevhekana	t_> E B E k_> a n a
tevhekanaho	t_> E B E k_> a n a h\ O
tevhela	t_> E B E l a
tevhelaho	t_> E B E l a h\ O
tevhele	t_> E B E l E
tevhelela	t_> E B E l E l a
tevhelelana	t_> E B E l E l a n a
tevhelelanaho	t_> E B E l E l a n a h\ O
tevhelelei	t_> E B E l E l E i
tevheli	t_> E B E l i
tevhelwa	t_> E B E l w a
tevhula	t_> E B u l a
tevhutshela	t_> E B u tS_h E l a
tevhuwa	t_> E B u w a
tewa	t_> E w a
tewaho	t_> E w a h\ O
thaa	t_h a a
thadzo	t_h a dz O
thaidzo	t_h a i dz O
thakhula	t_h a k_h u l a
thalusamaipfi	t_h a l u s a m a i p_> f i
thalutshedzo	t_h a l u tS_h E dz O
thama	t_h a m a
thamara	t_h a m a r a
thambo	t_h a m b O
thambouri	t_h a m b O u r i
thambudzo	t_h a m b u dz O
thanda	t_h a n d a
thandela	t_h a n d E l a
thandululo	t_h a n d u l u l O
thanga	t_h a n g a
thangana	t_h a n g a n a
thanganyelo	t_h a n g a J E l O
thangelakhandiso	t_h a n g E l a k_h a n d i s O
thangi	t_h a n g i
thanu	t_h a n u
thanyani	t_h a J a n i
thanye	t_h a J E
thanzi	t_h a n z i
thanziela	t_h a n z i E l a
tharu	t_h a r u
thasulula	t_h a s u l u l a
thasululea	t_h a s u l u l E a
thasululo	t_h a s u l u l O
thasululwa	t_h a s u l u l w a
thasululwe	t_h a s u l u l w E
thathani	t_h a t_h a n i
thaula	t_h a u l a
thavha	t_h a B a
thavhani	t_h a B a n i
the	d E
the	t_h E
theikinolodzhi	t_h E i k_> i n O l O dz h\ i
thekhinikhala	t_h E k_h i n i k_h a l a
thekhino	t_h E k_h i n O
thekhinolodzhi	t_h E k_h i n O l O dz h\ i
thekhinoḽodzhi	t_h E k_h i n O l O dz h\ i
thekhisi	t_h E k_h i s i
thekinini	t_h E k_> i n i n i
thekinolodzhi	t_h E k_> i n O l O dz h\ i
thekinoḽodzhi	t_h E k_> i n O l O dz h\ i
thela	t_h E l a
theliswaho	t_h E l i sw a h\ O
themamveledziso	t_h E m a m v E l E dz i s O
thembisa	t_h E m b i s a
themendela	t_h E m E n d E l a
themendele	t_h E m E n d E l E
themendelo	t_h E m E n d E l O
themendelwa	t_h E m E n d E l w a
themendelwaho	t_h E m E n d E l w a h\ O
themes	f i m z
themes	t_h E m E s
themino	t_h E m i n O
theminogirafi	t_h E m i n O g i r a f i
theminolodzhi	t_h E m i n O l O dz h\ i
thempuleithi	t_h E m p_> u l E i t_h i
thenda	t_h E n d a
thendara	t_h E n d a r a
thendela	t_h E n d E l a
thendelano	t_h E n d E l a n O
thendelanoya	t_h E n d E l a n O j a
thendeleki	t_h E n d E l E k_> i
thendelo	t_h E n d E l O
thendo	t_h E n d O
thengiselonn	t_h E n g i s E l O n n
thengiso	t_h E n g i s O
thengo	t_h E n g O
thengwe	t_h E n g w E
thenu	t_h E n u
thenzhemo	t_h E n Z E m O
theomveledziso	t_h E O m v E l E dz i s O
theory	f E r i
theory	t_h E O r j
therisano	t_h E r i s a n O
thero	t_h E r O
theshiari	t_h E S i a r i
theta	t_h E t_> a
thethe	t_h E t_h E
thethelesi	t_h E t_h E l E s i
thetshelesa	t_h E tS_h E l E s a
thetshelese	t_h E tS_h E l E s E
thetshelesi	t_h E tS_h E l E s i
thetsheleswa	t_h E tS_h E l E sw a
thetsheleswe	t_h E tS_h E l E sw E
thevhekano	t_h E B E k_> a n O
thewaho	t_h E w a h\ O
theḽevishini	t_h E l E v i S i n i
thi	t_h i
thihi	t_h i h\ i
thiho	t_h i h\ O
thikedzo	t_h i k_> E dz O
thikhedzo	t_h i k_h E dz O
thikhithi	t_h i k_h i t_h i
thikho	t_h i k_h O
thikhwa	t_h i k_h w a
thimu	t_h i m u
thina	t_h i n a
thinawanga	t_h i n a w a n g a
thingo	t_h i n g O
thithisa	t_h i t_h i s a
thithisea	t_h i t_h i s E a
thithisi	t_h i t_h i s i
thithiswa	t_h i t_h i sw a
thivha	t_h i B a
thivhana	t_h i B a n a
thivhela	t_h i B E l a
thivhele	t_h i B E l E
thivhelei	t_h i B E l E i
thivheli	t_h i B E l i
thivhelwa	t_h i B E l w a
thivhelwe	t_h i B E l w E
tho	t_h O
thodea	t_h O d_0Z E a
thodisiso	t_h O d_0Z i s i s O
thogomela	t_h O g O m E l a
thogomelo	t_h O g O m E l O
thogomelwa	t_h O g O m E l w a
thoho	t_h O h\ O
thohoyandou	t_h O h\ O j a n d O u
thohoyanḓ	t_h O h\ O j a n d
thola	t_h O l a
thole	f h\ O l
thole	t_h O l E
tholelwa	t_h O l E l w a
tholiwa	t_h O l i w a
tholiwaho	t_h O l i w a h\ O
tholiwe	t_h O l i w E
tholwa	t_h O l w a
tholwaho	t_h O l w a h\ O
thoma	t_h O m a
thomaho	t_h O m a h\ O
thomai	t_h O m a i
thomani	t_h O m a n i
thomasi	t_h O m a s i
thome	t_h O m E
thomi	t_h O m i
thomiwa	t_h O m i w a
thomiwaho	t_h O m i w a h\ O
thondo	t_h O n d O
thondoni	t_h O n d O n i
thonga	t_h O n g a
thoni	t_h O n i
thonifha	t_h O n i p\ a
thonifhe	t_h O n i p\ E
thonifhiwa	t_h O n i p\ i w a
thoro	t_h O r O
thotha	t_h O t_h a
thothotho	t_h O t_h O t_h O
thouni	t_h O u n i
thovhela	t_h O B E l a
thovhele	t_h O B E l E
thovhoni	t_h O B O n i
thoḓea	t_h O d E a
thrip	t_h r i p_h
thu	t_h u
thudzela	t_h u dz E l a
thudzelwa	t_h u dz E l w a
thukhu	t_h u k_h u
thulwa	t_h u l w a
thumbu	t_h u m b u
thumbuni	t_h u m b u n i
thundu	t_h u n d u
thungo	t_h u n g O
thunguvhala	t_h u n g u B a l a
thuntsha	t_h u n tS_h a
thunzi	t_h u n z i
thuos	t_h u O s
thusa	t_h u s a
thusaho	t_h u s a h\ O
thusana	t_h u s a n a
thuse	t_h u s E
thusea	t_h u s E a
thusedza	t_h u s E dz a
thusedzo	t_h u s E dz O
thusi	t_h u s i
thusiwa	t_h u s i w a
thuso	t_h u s O
thuswa	t_h u sw a
thutha	t_h u t_h a
thuthisa	t_h u t_h i s a
thuthiwa	t_h u t_h i w a
thuthiwe	t_h u t_h i w E
thuthuwedzo	t_h u t_h u w E dz O
thuvhula	t_h u B u l a
tiba	t_> i b a
tie	t_h a
tie	t_> i E
tikaho	t_> i k_> a h\ O
tikedza	t_> i k_> E dz a
tikedzaho	t_> i k_> E dz a h\ O
tikedzana	t_> i k_> E dz a n a
tikedzani	t_> i k_> E dz a n i
tikedze	t_> i k_> E dz E
tikedzelwaho	t_> i k_> E dz E l w a h\ O
tikedzi	t_> i k_> E dz i
tikedziwa	t_> i k_> E dz i w a
tikedzwa	t_> i k_> E dz w a
tikedzwaho	t_> i k_> E dz w a h\ O
tikiwa	t_> i k_> i w a
tikwaho	t_> i k_> w a h\ O
timatima	t_> i m a t_> i m a
time	t_h a m
time	t_> i m E
times	t_h a m z
times	t_> i m E s
timhaka	t_> i m a k_> a
tinya	t_> i J a
tisa	t_> i s a
tissa	t_> i s s a
tiwa	t_> i w a
tiwaho	t_> i w a h\ O
tkhou	t_> k_h O u
to	t_h u
to	t_> O
tod	t_> O d_0Z
toda	t_> O d_0Z a
todea	t_> O d_0Z E a
todeaho	t_> O d_0Z E a h\ O
todi	t_> O d_0Z i
todisisa	t_> O d_0Z i s i s a
toe	t_h O
toe	t_> O E
tola	t_> O l a
toliwa	t_> O l i w a
tolou	t_> O l O u
tombo	t_> O m b O
tona	t_> O n a
tonga	t_h a N g E
tonga	t_> O n g a
toni	t_h a n a
toni	t_> O n i
tony	t_h O n i
tony	t_> O J
topolani	t_> O p_> O l a n i
topoleni	t_> O p_> O l E n i
topoliwa	t_> O p_> O l i w a
topological	t_h O p_h E l O d_0Z i k_h E l
totiwaho	t_> O t_> i w a h\ O
tou	t_> O u
tovholwa	t_> O B O l w a
trade	t_h r E d
trade	t_> r a d_0Z E
transfer	t_h r a n s f a r
transfer	t_> r a n s f E r
transnet	t_> r a n s n E t_>
transport	t_h r a n s p_h O t_h
transport	t_> r a n s p_> O r t_>
treaty	t_h r i t_h i
treaty	t_> r E a t_h
tree	t_h r i
tree	t_> r E E
trees	t_h r i z
trees	t_> r E E s
trust	t_h r a s t_h
trust	t_> r u s t_>
tsa	ts_> a
tsaini	ts_> a i n i
tsaino	ts_> a i n O
tsanananana	ts_> a n a n a n a n a
tsaṅwa	ts_> a n w a
tse	ts_> E
tsedzuluso	ts_> E dz u l u s O
tsela	ts_> E l a
tselaho	ts_> E l a h\ O
tsengo	ts_> E n g O
tsengoni	ts_> E n g O n i
tsenguluso	ts_> E n g u l u s O
tserakano	ts_> E r a k_> a n O
tseramisiamelo	ts_> E r a m i s i a m E l O
tserekano	ts_> E r E k_> a n O
tsesaho	ts_> E s a h\ O
tsha	tS_h a
tshadzhi	tS_h a dz h\ i
tshadzo	tS_h a dz O
tshaeo	tS_h a E O
tshaini	tS_h a i n i
tshaisiwa	tS_h a i s i w a
tshaka	tS_h a k_> a
tshakha	tS_h a k_h a
tshakhuma	tS_h a k_h u m a
tshamonde	tS_h a m O n d E
tshana	tS_h a n a
tshanda	tS_h a n d a
tshandama	tS_h a n d a m a
tshandukiso	tS_h a n d u k_> i s O
tshanduko	tS_h a n d u k_> O
tshanele	tS_h a n E l E
tshanu	tS_h a n u
tshanḓa	tS_h a n d a
tshanḓanguvhoni	tS_h a n d a n g u B O n i
tshanḓnguvhoni	tS_h a n d n g u B O n i
tshararu	tS_h a r a r u
tshashu	tS_h a S u
tshata	tS_h a t_> a
tshatha	tS_h a t_h a
tshau	tS_h a u
tshaula	tS_h a u l a
tshaulu	tS_h a u l u
tshavhi	tS_h a B i
tshavho	tS_h a B O
tshavhudi	tS_h a B u d_0Z i
tshavhuḓi	tS_h a B u d i
tshawe	tS_h a w E
tshaye	tS_h a j E
tshayo	tS_h a j O
tshaṅu	tS_h a n u
tshaṋu	tS_h a n u
tshe	tS_h E
tshea	tS_h E a
tshedza	tS_h E dz a
tshee	tS_h E E
tsheke	tS_h E k_> E
tshele	tS_h E l E
tshelede	tS_h E l E d_0Z E
tsheledo	tS_h E l E d_0Z O
tshema	tS_h E m a
tshena	tS_h E n a
tshenetshiḽa	tS_h E n E tS_h i l a
tshenetsho	tS_h E n E tS_h O
tshenguluso	tS_h E n g u l u s O
tshenzemo	tS_h E n z E m O
tshenzhemo	tS_h E n Z E m O
tsheo	tS_h E O
tshetshelelwaho	tS_h E tS_h E l E l w a h\ O
tshetshelesa	tS_h E tS_h E l E s a
tshetshelese	tS_h E tS_h E l E s E
tshetshelwaho	tS_h E tS_h E l w a h\ O
tshetsho	tS_h E tS_h O
tshi	tS_h i
tshiambaro	tS_h i a m b a r O
tshiangaladzi	tS_h i a n g a l a dz i
tshiangu	tS_h i a n g u
tshianzhe	tS_h i a n Z E
tshiavha	tS_h i a B a
tshiawelo	tS_h i a w E l O
tshibadela	tS_h i b a d_0Z E l a
tshibeli	tS_h i b E l i
tshibogisi	tS_h i b O g i s i
tshibudzana	tS_h i b u dz a n a
tshibveledzwa	tS_h i b v E l E dz w a
tshidakwa	tS_h i d_0Z a k_> w a
tshidanga	tS_h i d_0Z a n g a
tshidangani	tS_h i d_0Z a n g a n i
tshidindi	tS_h i d_0Z i n d i
tshidindini	tS_h i d_0Z i n d i n i
tshidulo	tS_h i d_0Z u l O
tshiduloni	tS_h i d_0Z u l O n i
tshidza	tS_h i dz a
tshidzabi	tS_h i dz a b i
tshidzaho	tS_h i dz a h\ O
tshidzamanga	tS_h i dz a m a n g a
tshidzidzivhadzi	tS_h i dz i dz i B a dz i
tshidzini	tS_h i dz i n i
tshidzulo	tS_h i dz u l O
tshidzumbe	tS_h i dz u m b E
tshiedziso	tS_h i E dz i s O
tshiendedzi	tS_h i E n d E dz i
tshiendeulu	tS_h i E n d E u l u
tshiendisi	tS_h i E n d i s i
tshienge	tS_h i E n g E
tshifa	tS_h i f a
tshifani	tS_h i f a n i
tshifanyiso	tS_h i f a J i s O
tshifase	tS_h i f a s E
tshifha	tS_h i p\ a
tshifhambano	tS_h i p\ a m b a n O
tshifhango	tS_h i p\ a n g O
tshifhao	tS_h i p\ a O
tshifhaṱo	tS_h i p\ a t_> O
tshifhaṱuwo	tS_h i p\ a t_> u w O
tshifhe	tS_h i p\ E
tshifhinga	tS_h i p\ i n g a
tshifhingade	tS_h i p\ i n g a d_0Z E
tshifhingani	tS_h i p\ i n g a n i
tshifhinganya	tS_h i p\ i n g a J a
tshifhinganyana	tS_h i p\ i n g a J a n a
tshifhinhanyana	tS_h i p\ i n a J a n a
tshifhio	tS_h i p\ i O
tshifihnga	tS_h i f i h\ n g a
tshifudi	tS_h i f u d_0Z i
tshifula	tS_h i f u l a
tshifulanani	tS_h i f u l a n a n i
tshifuwo	tS_h i f u w O
tshiga	tS_h i g a
tshigan	tS_h i g a n
tshigevhedu	tS_h i g E B E d_0Z u
tshigevhenga	tS_h i g E B E n g a
tshigidi	tS_h i g i d_0Z i
tshigomamutanda	tS_h i g O m a m u t_> a n d a
tshigombela	tS_h i g O m b E l a
tshigombelani	tS_h i g O m b E l a n i
tshigompfana	tS_h i g O m p_> f a n a
tshigwada	tS_h i g w a d_0Z a
tshigwevho	tS_h i g w E B O
tshigwili	tS_h i g w i l i
tshihadu	tS_h i h\ a d_0Z u
tshihadzinga	tS_h i h\ a dz i n g a
tshihali	tS_h i h\ a l i
tshihaḓu	tS_h i h\ a d u
tshihulu	tS_h i h\ u l u
tshihulusa	tS_h i h\ u l u s a
tshihulwane	tS_h i h\ u l w a n E
tshiilwa	tS_h i i l w a
tshiimiswa	tS_h i i m i sw a
tshiimo	tS_h i i m O
tshiisimane	tS_h i i s i m a n E
tshiitisi	tS_h i i t_> i s i
tshiivhumbiwa	tS_h i i B u m b i w a
tshika	tS_h i k_> a
tshikafhadza	tS_h i k_> a p\ a dz a
tshikafhadzwa	tS_h i k_> a p\ a dz w a
tshikafhala	tS_h i k_> a p\ a l a
tshikalo	tS_h i k_> a l O
tshikanda	tS_h i k_> a n d a
tshikandani	tS_h i k_> a n d a n i
tshikepe	tS_h i k_> E p_> E
tshikete	tS_h i k_> E t_> E
tshiketshe	tS_h i k_> E tS_h E
tshikha	tS_h i k_h a
tshikhafuthini	tS_h i k_h a f u t_h i n i
tshikhala	tS_h i k_h a l a
tshikhalani	tS_h i k_h a l a n i
tshikhau	tS_h i k_h a u
tshikhou	tS_h i k_h O u
tshikhudini	tS_h i k_h u d_0Z i n i
tshikhukhulisi	tS_h i k_h u k_h u l i s i
tshikhukhuliso	tS_h i k_h u k_h u l i s O
tshikhuwani	tS_h i k_h u w a n i
tshikimu	tS_h i k_> i m u
tshiko	tS_h i k_> O
tshikoli	tS_h i k_> O l i
tshikolo	tS_h i k_> O l O
tshikolobulasi	tS_h i k_> O l O b u l a s i
tshikolodo	tS_h i k_> O l O d_0Z O
tshikoloni	tS_h i k_> O l O n i
tshikona	tS_h i k_> O n a
tshikonelo	tS_h i k_> O n E l O
tshikoro	tS_h i k_> O r O
tshikota	tS_h i k_> O t_> a
tshikriste	tS_h i k_> r i s t_> E
tshikumba	tS_h i k_> u m b a
tshikwama	tS_h i k_> w a m a
tshikwamani	tS_h i k_> w a m a n i
tshikwara	tS_h i k_> w a r a
tshikwati	tS_h i k_> w a t_> i
tshikwekwete	tS_h i k_> w E k_> w E t_> E
tshila	tS_h i l a
tshilaho	tS_h i l a h\ O
tshilala	tS_h i l a l a
tshilapfu	tS_h i l a p_> f u
tshilata	tS_h i l a t_> a
tshilavhi	tS_h i l a B i
tshile	tS_h i l E
tshilela	tS_h i l E l a
tshileme	tS_h i l E m E
tshilidzi	tS_h i l i dz i
tshilidzini	tS_h i l i dz i n i
tshilikadzi	tS_h i l i k_> a dz i
tshililelwa	tS_h i l i l E l w a
tshililo	tS_h i l i l O
tshilimo	tS_h i l i m O
tshilisa	tS_h i l i s a
tshilisana	tS_h i l i s a n a
tshiloloni	tS_h i l O l O n i
tshilomondundundu	tS_h i l O m O n d u n d u n d u
tshilu	tS_h i l u
tshilume	tS_h i l u m E
tshilwavhusiku	tS_h i l w a B u s i k_> u
tshimangadzo	tS_h i m a n g a dz O
tshimbedzi	tS_h i m b E dz i
tshimbidza	tS_h i m b i dz a
tshimbidzana	tS_h i m b i dz a n a
tshimbidzani	tS_h i m b i dz a n i
tshimbidze	tS_h i m b i dz E
tshimbidzo	tS_h i m b i dz O
tshimbidzwa	tS_h i m b i dz w a
tshimbidzwe	tS_h i m b i dz w E
tshimbila	tS_h i m b i l a
tshimbilanyana	tS_h i m b i l a J a n a
tshimbile	tS_h i m b i l E
tshimbilelana	tS_h i m b i l E l a n a
tshimbilelanaho	tS_h i m b i l E l a n a h\ O
tshimbilelane	tS_h i m b i l E l a n E
tshimbili	tS_h i m b i l i
tshimbupfe	tS_h i m b u p_> f E
tshimebi	tS_h i m E b i
tshimedzi	tS_h i m E dz i
tshimela	tS_h i m E l a
tshimondeni	tS_h i m O n d E n i
tshimvumvusi	tS_h i m v u m v u s i
tshina	tS_h i n a
tshinada	tS_h i n a d_0Z a
tshinanḓala	tS_h i n a n d a l a
tshinda	tS_h i n d a
tshindevhele	tS_h i n d E B E l E
tshindolendole	tS_h i n d O l E n d O l E
tshine	tS_h i n E
tshinefu	tS_h i n E f u
tshingafhani	tS_h i n g a p\ a n i
tshiniwa	tS_h i n i w a
tshinnani	tS_h i n n a n i
tshino	tS_h i n O
tshinoni	tS_h i n O n i
tshinovhea	tS_h i n O B E a
tshintsha	tS_h i n tS_h a
tshintshana	tS_h i n tS_h a n a
tshintshea	tS_h i n tS_h E a
tshintshiwa	tS_h i n tS_h i w a
tshinwa	tS_h i n w a
tshinwe	tS_h i n w E
tshinya	tS_h i J a
tshinyadza	tS_h i J a dz a
tshinyadzwa	tS_h i J a dz w a
tshinyala	tS_h i J a l a
tshinyalelo	tS_h i J a l E l O
tshinzhi	tS_h i n Z i
tshiofhiso	tS_h i O p\ i s O
tshiofisi	tS_h i O f i s i
tshiolwa	tS_h i O l w a
tshipa	tS_h i p_> a
tshipambala	tS_h i p_> a m b a l a
tshipembe	tS_h i p_> E m b E
tshipengo	tS_h i p_> E n g O
tshipentshala	tS_h i p_> E n tS_h a l a
tshipentshela	tS_h i p_> E n tS_h E l a
tshipentshele	tS_h i p_> E n tS_h E l E
tshipeshala	tS_h i p_> E S a l a
tshipfufhi	tS_h i p_> f u p\ i
tshiphani	tS_h i p_h a n i
tshiphiri	tS_h i p_h i r i
tshiphirini	tS_h i p_h i r i n i
tshipholisa	tS_h i p_h O l i s a
tshiphurofeshenaḽa	tS_h i p_h u r O f E S E n a l a
tshiphurofeshinala	tS_h i p_h u r O f E S i n a l a
tshipi	tS_h i p_> i
tshipia	tS_h i p_> i a
tshipida	tS_h i p_> i d_0Z a
tshipikwa	tS_h i p_> i k_> w a
tshipiro	tS_h i p_> i r O
tshipiwa	tS_h i p_> i w a
tshipiḓa	tS_h i p_> i d a
tshirema	tS_h i r E m a
tshirendo	tS_h i r E n d O
tshirendoni	tS_h i r E n d O n i
tshirenzheni	tS_h i r E n Z E n i
tshiri	tS_h i r i
tshirululuni	tS_h i r u l u l u n i
tshirumbi	tS_h i r u m b i
tshirumbule	tS_h i r u m b u l E
tshirunzi	tS_h i r u n z i
tshisa	tS_h i s a
tshiselo	tS_h i s E l O
tshiseluselu	tS_h i s E l u s E l u
tshisevhe	tS_h i s E B E
tshishonga	tS_h i S O n g a
tshishumisa	tS_h i S u m i s a
tshishumiswa	tS_h i S u m i sw a
tshisibe	tS_h i s i b E
tshisima	tS_h i s i m a
tshisulu	tS_h i s u l u
tshisuthu	tS_h i s u t_h u
tshiswa	tS_h i sw a
tshiswati	tS_h i sw a t_> i
tshiswiṱulo	tS_h i sw i t_> u l O
tshitaela	tS_h i t_> a E l a
tshitafu	tS_h i t_> a f u
tshitaila	tS_h i t_> a i l a
tshitalula	tS_h i t_> a l u l a
tshitamba	tS_h i t_> a m b a
tshitandani	tS_h i t_> a n d a n i
tshitatamennde	tS_h i t_> a t_> a m E n n d E
tshite	tS_h i t_> E
tshiteidzhi	tS_h i t_> E i dz h\ i
tshitekeshi	tS_h i t_> E k_> E S i
tshitengeledzi	tS_h i t_> E n g E l E dz i
tshitentsi	tS_h i t_> E n ts_> i
tshiteṅwa	tS_h i t_> E n w a
tshithekhiniki	tS_h i t_h E k_h i n i k_> i
tshithihi	tS_h i t_h i h\ i
tshithosa	tS_h i t_h O s a
tshithoza	tS_h i t_h O z a
tshithu	tS_h i t_h u
tshithutshavhudi	tS_h i t_h u tS_h a B u d_0Z i
tshitika	tS_h i t_> i k_> a
tshitirathedzhi	tS_h i t_> i r a t_h E dz h\ i
tshitiriki	tS_h i t_> i r i k_> i
tshitoni	tS_h i t_> O n i
tshitori	tS_h i t_> O r i
tshitshavha	tS_h i tS_h a B a
tshitshena	tS_h i tS_h E n a
tshitshili	tS_h i tS_h i l i
tshitsonga	tS_h i ts_> O n g a
tshitswana	tS_h i ts_> w a n a
tshitumbani	tS_h i t_> u m b a n i
tshitumbe	tS_h i t_> u m b E
tshitumbu	tS_h i t_> u m b u
tshitunde	tS_h i t_> u n d E
tshivend	tS_h i v E n d
tshivenda	tS_h i v E n d a
tshivenḓa	tS_h i v E n d a
tshivhalo	tS_h i B a l O
tshivhasa	tS_h i B a s a
tshivhase	tS_h i B a s E
tshivhi	tS_h i B i
tshivhidzelwa	tS_h i B i dz E l w a
tshivhindi	tS_h i B i n d i
tshivhonakule	tS_h i B O n a k_> u l E
tshivhonelo	tS_h i B O n E l O
tshivhonini	tS_h i B O n i n i
tshivhumbeo	tS_h i B u m b E O
tshivhumbiwa	tS_h i B u m b i w a
tshivhuru	tS_h i B u r u
tshiwe	tS_h i w E
tshizulu	tS_h i z u l u
tshizwino	tS_h i zw i n O
tshiḓereke	tS_h i d E r E k_> E
tshiḓivhano	tS_h i d i B a n O
tshiḽa	tS_h i l a
tshiḽipi	tS_h i l i p_> i
tshiḽiso	tS_h i l i s O
tshiṅwe	tS_h i n w E
tshiṋoni	tS_h i n O n i
tshiṋwe	tS_h i n w E
tshiṱafu	tS_h i t_> a f u
tshiṱalula	tS_h i t_> a l u l a
tshiṱangani	tS_h i t_> a n g a n i
tshiṱangu	tS_h i t_> a n g u
tshiṱara	tS_h i t_> a r a
tshiṱefu	tS_h i t_> E f u
tshiṱemmbe	tS_h i t_> E m b E
tshiṱempe	tS_h i t_> E m p_> E
tshiṱereke	tS_h i t_> E r E k_> E
tshiṱhannga	tS_h i t_h a n n g a
tshiṱirathedzhi	tS_h i t_> i r a t_h E dz h\ i
tshiṱiriki	tS_h i t_> i r i k_> i
tshiṱitshi	tS_h i t_> i tS_h i
tshiṱitshini	tS_h i t_> i tS_h i n i
tshiṱoko	tS_h i t_> O k_> O
tshiṱokoni	tS_h i t_> O k_> O n i
tshiṱori	tS_h i t_> O r i
tshiṱuhu	tS_h i t_> u h\ u
tshiṱuku	tS_h i t_> u k_> u
tshiṱuni	tS_h i t_> u n i
tsho	tS_h O
tshohe	tS_h O h\ E
tshomedzo	tS_h O m E dz O
tshone	tS_h O n E
tshori	tS_h O r i
tshothe	tS_h O t_h E
tshoṱhe	tS_h O t_h E
tshubu	tS_h u b u
tshugulu	tS_h u g u l u
tshukhwii	tS_h u k_h w i i
tshumban	tS_h u m b a n
tshumela	tS_h u m E l a
tshumelo	tS_h u m E l O
tshumisano	tS_h u m i s a n O
tshumiso	tS_h u m i s O
tshumisoni	tS_h u m i s O n i
tshutshedzo	tS_h u tS_h E dz O
tshutshisa	tS_h u tS_h i s a
tshuwa	tS_h u w a
tshwane	tS_h w a n E
tsianda	ts_> i a n d a
tsike	ts_> i k_> E
tsikeledza	ts_> i k_> E l E dz a
tsikeledzwa	ts_> i k_> E l E dz w a
tsiko	ts_> i k_> O
tsiku	ts_> i k_> u
tsimbe	ts_> i m b E
tsimbela	ts_> i m b E l a
tsimbi	ts_> i m b i
tsimu	ts_> i m u
tsindi	ts_> i n d i
tsinga	ts_> i n g a
tsini	ts_> i n i
tsinisa	ts_> i n i s a
tsireledz	ts_> i r E l E dz
tsireledza	ts_> i r E l E dz a
tsireledze	ts_> i r E l E dz E
tsireledzea	ts_> i r E l E dz E a
tsireledzeaho	ts_> i r E l E dz E a h\ O
tsireledzo	ts_> i r E l E dz O
tsireledzwa	ts_> i r E l E dz w a
tsireledzwaho	ts_> i r E l E dz w a h\ O
tsitsikanaho	ts_> i ts_> i k_> a n a h\ O
tsivhudza	ts_> i B u dz a
tsivhudzo	ts_> i B u dz O
tsiwana	ts_> i w a n a
tsumbamaitele	ts_> u m b a m a i t_> E l E
tsumbamushumo	ts_> u m b a m u S u m O
tsumbanḓila	ts_> u m b a n d i l a
tsumbathengo	ts_> u m b a t_h E n g O
tsumbatshiga	ts_> u m b a tS_h i g a
tsumbavhuyo	ts_> u m b a B u j O
tsumbavhuṅe	ts_> u m b a B u N E
tsumbedzo	ts_> u m b E dz O
tsumbo	ts_> u m b O
tswa	ts_> w a
tswayo	ts_> w a j O
tswii	ts_> w i i
tswikelelo	ts_> w i k_> E l E l O
tswiwa	ts_> w i w a
tswuku	ts_> w u k_> u
tswukuluwa	ts_> w u k_> u l u w a
tube	t_h j u b
tube	t_> u b E
tukufhadza	t_> u k_> u p\ a dz a
tumana	t_> u m a n a
tumani	t_> u m a n i
tumanya	t_> u m a J a
tumanywa	t_> u m a J w a
tumba	t_> u m b a
tumbula	t_> u m b u l a
tumbulwa	t_> u m b u l w a
tumuwi	t_> u m u w i
tunda	t_> u n d a
tunzuwa	t_> u n z u w a
tupule	t_> u p_> u l E
tupulwa	t_> u p_> u l w a
tutula	t_> u t_> u l a
tutuwedza	t_> u t_> u w E dz a
tutuwedzana	t_> u t_> u w E dz a n a
tutuwedze	t_> u t_> u w E dz E
tv	t_> B
tv	t_h i v i
u	j u
ufhio	u p\ i O
ugisela	u g i s E l a
ugobela	u g O b E l a
uh	u h\
uho	u h\ O
uhu	u h\ u
uif	u i p\
ukhuthela	u k_h u t_h E l a
uku	u k_> u
ukwo	u k_> w O
ukwu	u k_> w u
ulu	u l u
ulukana	u l u k_> a n a
ulukanya	u l u k_> a J a
ulusi	u l u s i
uluso	u l u s O
ulwo	u l w O
uma	u m a
umana	u m a n a
umashonzha	u m a S O n Z a
umu	u m u
un	u n
una	u n a
undele	u n d E l E
une	u n E
unele	u n E l E
unesco	j u n E s k_h O
unga	u n g a
ungani	u n g a n i
ungeledza	u n g E l E dz a
union	j u n E n
union	u n i O n
united	j u n a t_h E d
united	u n i t_> E d_0Z
universal	j u n i v a s E l
universal	u n i v E r s a l
university	j u n i v a s E t_h i
university	u n i v E r s i t_h
uniyoni	u n i j O n i
uno	u n O
unḓa	u n d a
unḓwa	u n d w a
upfi	u p_> f i
uraho	u r a h\ O
uri	u r i
urimaipfi	u r i m a i p_> f i
urimuthu	u r i m u t_h u
urui	u r u i
usa	j u E s E
usa	u s a
user	j u z E r
user	u s E r
ussasa	u s s a s a
ut	u t_>
utea	u t_> E a
uula	u l a
uuwedza	u w E dz a
uuwedzwa	u w E dz w a
uvha	u B a
uvho	u B O
uvhu	u B u
uwedza	u w E dz a
uwedziwe	u w E dz i w E
uya	u j a
uyo	u j O
uyu	u j u
uḓo	u d O
uḽa	u l a
v	v i
vala	v a l a
valelwa	v a l E l w a
valence	v a l E n s
valisa	v a l i s a
values	v a l j u z
values	v a l u E s
valuvalu	v a l u v a l u
valwa	v a l w a
vasco	v a s k_h O
vat	v a t_>
vat	v a t_h
velaphanḓa	v E l a p_h a n d a
venda	v E n d a
vengo	v E n g O
veni	v E n i
venice	v E n E s
venḓa	v E n d a
vep	v E p_>
veḽivethi	v E l i v E t_h i
vha	B a
vhaa	B a a
vhaadivokati	B a a d_0Z i v O k_> a t_> i
vhaaleli	B a a l E l i
vhaalulwa	B a a l u l w a
vhaaluwa	B a a l u w a
vhaanewa	B a a n E w a
vhabadela	B a b a d_0Z E l a
vhabebi	B a b E b i
vhabindudzi	B a b i n d u dz i
vhabvann	B a b v a n n
vhabvannḓa	B a b v a n n d a
vhad	B a d
vhadabe	B a d_0Z a b E
vhadahi	B a d_0Z a h\ i
vhadalela	B a d_0Z a l E l a
vhadau	B a d_0Z a u
vhadededzi	B a d_0Z E d_0Z E dz i
vhadivhalea	B a d_0Z i B a l E a
vhadivhi	B a d_0Z i B i
vhadzadze	B a dz a dz E
vhadzimu	B a dz i m u
vhadzitshaka	B a dz i tS_h a k_> a
vhadzulapo	B a dz u l a p_> O
vhadzulatsini	B a dz u l a ts_> i n i
vhae	B a E
vhaeletshedzi	B a E l E tS_h E dz i
vhaendanganayo	B a E n d a n g a n a j O
vhaeni	B a E n i
vhafaramikovhe	B a f a r a m i k_> O B E
vhafarisa	B a f a r i s a
vhafarisi	B a f a r i s i
vhafariwa	B a f a r i w a
vhafhaṱi	B a p\ a t_> i
vhafhinduleli	B a p\ i n d u l E l i
vhafhio	B a p\ i O
vhafhiyo	B a p\ i j O
vhafiḽisita	B a f i l i s i t_> a
vhafiḽista	B a f i l i s t_> a
vhafumakadzi	B a f u m a k_> a dz i
vhafunashango	B a f u n a S a n g O
vhafunzi	B a f u n z i
vhagudi	B a g u d_0Z i
vhagudisi	B a g u d_0Z i s i
vhagudiswa	B a g u d_0Z i sw a
vhahadzimiswa	B a h\ a dz i m i sw a
vhahali	B a h\ a l i
vhahashu	B a h\ a S u
vhahatuli	B a h\ a t_> u l i
vhahaṱuli	B a h\ a t_> u l i
vhaho	B a h\ O
vhaholefhali	B a h\ O l E p\ a l i
vhahulu	B a h\ u l u
vhahulwane	B a h\ u l w a n E
vhahumbeli	B a h\ u m b E l i
vhahumbulela	B a h\ u m b u l E l a
vhahumbulelwa	B a h\ u m b u l E l w a
vhaimeleli	B a i m E l E l i
vhaimeli	B a i m E l i
vhaisa	B a i s a
vhaisala	B a i s a l a
vhaisi	B a i s i
vhaisiraele	B a i s i r a E l E
vhaisraele	B a i s r a E l E
vhaiti	B a i t_> i
vhakalaha	B a k_> a l a h\ a
vhakale	B a k_> a l E
vhakegulu	B a k_> E g u l u
vhakerube	B a k_> E r u b E
vhakhakhululi	B a k_h a k_h u l u l i
vhakhantselara	B a k_h a n ts_> E l a r a
vhakhethi	B a k_h E t_h i
vhakololo	B a k_> O l O l O
vhakoma	B a k_> O m a
vhakomana	B a k_> O m a n a
vhakonesi	B a k_> O n E s i
vhakwama	B a k_> w a m a
vhakwevho	B a k_> w E B O
vhala	B a l a
vhalaho	B a l a h\ O
vhalala	B a l a l a
vhalambedzi	B a l a m b E dz i
vhalanda	B a l a n d a
vhalangavunḓu	B a l a n g a v u n d u
vhalangi	B a l a n g i
vhalanguli	B a l a n g u l i
vhalaxwa	B a l a x w a
vhale	B a l E
vhalea	B a l E a
vhaledzani	B a l E dz a n i
vhalela	B a l E l a
vhalele	B a l E l E
vhalelwa	B a l E l w a
vhaleni	B a l E n i
vhalidi	B a l i d_0Z i
vhalidzi	B a l i dz i
vhalimi	B a l i m i
vhaliwa	B a l i w a
vhalula	B a l u l a
vhalullula	B a l u l l u l a
vhalulula	B a l u l u l a
vhalululwa	B a l u l u l w a
vhaluvhu	B a l u B u
vhaluṱanyi	B a l u t_> a J i
vhalwa	B a l w a
vhalwadze	B a l w a dz E
vhalwaho	B a l w a h\ O
vhamba	B a m b a
vhambadza	B a m b a dz a
vhambadzelana	B a m b a dz E l a n a
vhambadzelwa	B a m b a dz E l w a
vhambedza	B a m b E dz a
vhambedzea	B a m b E dz E a
vhambedzi	B a m b E dz i
vhambedzwa	B a m b E dz w a
vhamusanda	B a m u s a n d a
vhamutani	B a m u t_> a n i
vhan	B a n
vhana	B a n a
vhanameli	B a n a m E l i
vhananga	B a n a n g a
vhanda	B a n d a
vhandalala	B a n d a l a l a
vhandekana	B a n d E k_> a n a
vhane	B a n E
vhanekedzi	B a n E k_> E dz i
vhanetshedzi	B a n E tS_h E dz i
vhanga	B a n g a
vhangela	B a n g E l a
vhangiwa	B a n g i w a
vhangiwaho	B a n g i w a h\ O
vhangona	B a n g O n a
vhangwa	B a n g w a
vhangwaho	B a n g w a h\ O
vhanna	B a n n a
vhanwe	B a n w E
vhanwevhathannga	B a n w E B a t_h a n n g a
vhanzhi	B a n Z i
vhaofisi	B a O f i s i
vhaofisiri	B a O f i s i r i
vhaoisisi	B a O i s i s i
vhaoli	B a O l i
vhaongi	B a O n g i
vhapfumi	B a p_> f u m i
vhaphalestina	B a p_h a l E s t_> i n a
vhaphurosesi	B a p_h u r O s E s i
vhapikisi	B a p_> i k_> i s i
vhapo	B a p_> O
vhapomokwa	B a p_> O m O k_> w a
vhapondiwa	B a p_> O n d i w a
vhapondwa	B a p_> O n d w a
vhapulani	B a p_> u l a n i
vharamabindu	B a r a m a b i n d u
vharangaphan	B a r a n g a p_h a n
vharangaphana	B a r a n g a p_h a n a
vharangaphanda	B a r a n g a p_h a n d a
vharangaphanḓa	B a r a n g a p_h a n d a
vhararu	B a r a r u
vhareili	B a r E i l i
vharema	B a r E m a
vharengi	B a r E n g i
vharengisa	B a r E n g i s a
vharengisamivhili	B a r E n g i s a m i B i l i
vharengisi	B a r E n g i s i
vharwa	B a r w a
vhasa	B a s a
vhasadzi	B a s a dz i
vhasedzulusi	B a s E dz u l u s i
vhashai	B a S a i
vhashamisi	B a S a m i s i
vhashayaho	B a S a j a h\ O
vhashelamulenzhe	B a S E l a m u l E n Z E
vhasheli	B a S E l i
vhashu	B a S u
vhashumela	B a S u m E l a
vhashumelavhapo	B a S u m E l a B a p_> O
vhashumeli	B a S u m E l i
vhashumi	B a S u m i
vhashumisani	B a S u m i s a n i
vhashumisi	B a S u m i s i
vhasidzana	B a s i dz a n a
vhasiwa	B a s i w a
vhasiwana	B a s i w a n a
vhasiwe	B a s i w E
vhasuthu	B a s u t_h u
vhaswa	B a sw a
vhatambi	B a t_> a m b i
vhathannga	B a t_h a n n g a
vhatheli	B a t_h E l i
vhathetshelesi	B a t_h E tS_h E l E s i
vhathi	B a t_h i
vhathihi	B a t_h i h\ i
vhathogomeli	B a t_h O g O m E l i
vhatholi	B a t_h O l i
vhatholiwa	B a t_h O l i w a
vhathu	B a t_h u
vhathuni	B a t_h u n i
vhathusi	B a t_h u s i
vhatikedzi	B a t_> i k_> E dz i
vhatshena	B a tS_h E n a
vhatshimbidzi	B a tS_h i m b i dz i
vhatshini	B a tS_h i n i
vhatsivhudzi	B a ts_> i B u dz i
vhatukana	B a t_> u k_> a n a
vhauku	B a u k_> u
vhauniwa	B a u n i w a
vhaunḓi	B a u n d i
vhavenda	B a v E n d a
vhavenḓa	B a v E n d a
vhavha	B a B a
vhavhaho	B a B a h\ O
vhavhaleli	B a B a l E l i
vhavhali	B a B a l i
vhavhambadzi	B a B a m b a dz i
vhavhe	B a B E
vhavhi	B a B i
vhavhili	B a B i l i
vhavho	B a B O
vhavhoni	B a B O n i
vhavhusi	B a B u s i
vhavothi	B a v O t_h i
vhavouti	B a v O u t_> i
vhawani	B a w a n i
vhawe	B a w E
vhazwo	B a zw O
vhaḓa	B a d a
vhaḓadze	B a d a dz E
vhaḓisedzi	B a d i s E dz i
vhaḓivhi	B a d i B i
vhaḓuhulu	B a d u h\ u l u
vhaḽa	B a l a
vhaḽevi	B a l E v i
vhaṅe	B a n E
vhaṅwali	B a n w a l i
vhaṅwe	B a n w E
vhaṅweni	B a n w E n i
vhaṋe	B a n E
vhaṋetshedzi	B a n E tS_h E dz i
vhaṋu	B a n u
vhaṋwe	B a n w E
vhaṱaleli	B a t_> a l E l i
vhaṱanuni	B a t_> a n u n i
vhaṱhannga	B a t_h a n n g a
vhaṱuku	B a t_> u k_> u
vhe	B E
vhea	B E a
vhee	B E E
vhege	B E g E
vhei	B E i
vhekanya	B E k_> a J a
vhekanyiwa	B E k_> a J i w a
vhekanywa	B E k_> a J w a
vhembe	B E m b E
vhenga	B E n g a
vhetshelwa	B E tS_h E l w a
vhewa	B E w a
vhewaho	B E w a h\ O
vhewe	B E w E
vhi	B i
vhibvaho	B i b v a h\ O
vhidza	B i dz a
vhidze	B i dz E
vhidzelela	B i dz E l E l a
vhidzi	B i dz i
vhidziwe	B i dz i w E
vhidzwa	B i dz w a
vhidzwaho	B i dz w a h\ O
vhidzwe	B i dz w E
vhifha	B i p\ a
vhifhaho	B i p\ a h\ O
vhiga	B i g a
vhige	B i g E
vhigiwa	B i g i w a
vhigwa	B i g w a
vhila	B i l a
vhilaedzisa	B i l a E dz i s a
vhilaedzwa	B i l a E dz w a
vhilaela	B i l a E l a
vhilahela	B i l a h\ E l a
vhilei	B i l E i
vhilimedza	B i l i m E dz a
vhilisa	B i l i s a
vhilise	B i l i s E
vhiliswa	B i l i sw a
vhiliswaho	B i l i sw a h\ O
vhina	B i n a
vhine	B i n E
vhiwa	B i w a
vho	B O
vhofha	B O p\ a
vhofhanaho	B O p\ a n a h\ O
vhofhiwa	B O p\ i w a
vhofhololwa	B O p\ O l O l w a
vhofholowa	B O p\ O l O w a
vhofholowaho	B O p\ O l O w a h\ O
vhofholowe	B O p\ O l O w E
vhohe	B O h\ E
vhoina	B O i n a
vhoinwi	B O i n w i
vhomadzhisi	B O m a dz h\ i s i
vhomadzhisiṱiraṱa	B O m a dz h\ i s i t_> i r a t_> a
vhomaine	B O m a i n E
vhomakhadzi	B O m a k_h a dz i
vhomakhulu	B O m a k_h u l u
vhomalambane	B O m a l a m b a n E
vhomasipala	B O m a s i p_> a l a
vhominista	B O m i n i s t_> a
vhoministara	B O m i n i s t_> a r a
vhomme	B O m E
vhona	B O n a
vhonadza	B O n a dz a
vhonadze	B O n a dz E
vhonala	B O n a l a
vhonalaho	B O n a l a h\ O
vhonale	B O n a l E
vhonali	B O n a l i
vhonana	B O n a n a
vhonane	B O n a n E
vhondau	B O n d a u
vhone	B O n E
vhonesa	B O n E s a
vhongo	B O n g O
vhongwaniwapo	B O n g w a n i w a p_> O
vhoni	B O n i
vhonnyi	B O n J i
vhono	B O n O
vhonwa	B O n w a
vhonwe	B O n w E
vhoraakademi	B O r a a k_> a d_0Z E m i
vhorabulasi	B O r a b u l a s i
vhoradzikhon	B O r a dz i k_h O n
vhoramabindu	B O r a m a b i n d u
vhoramafhungo	B O r a m a p\ u n g O
vhoramilayo	B O r a m i l a j O
vhorasaintsi	B O r a s a i n ts_> i
vhorathekhiniki	B O r a t_h E k_h i n i k_> i
vhothe	B O t_h E
vhoxwa	B O x w a
vhoṱhe	B O t_h E
vhshumi	B S u m i
vhu	B u
vhua	B u a
vhuaifa	B u a i f a
vhualo	B u a l O
vhualuwa	B u a l u w a
vhuanu	B u a n u
vhuanzi	B u a n z i
vhuanḓadzamafhungo	B u a n d a dz a m a p\ u n g O
vhuaḓa	B u a d a
vhubindudzi	B u b i n d u dz i
vhubindundzi	B u b i n d u n d i
vhubvaḓuvha	B u b v a d u B a
vhubveledzi	B u b v E l E dz i
vhubvo	B u b v O
vhud	B u d
vhudalo	B u d_0Z a l O
vhudavhidzani	B u d_0Z a B i dz a n i
vhudavhidzano	B u d_0Z a B i dz a n O
vhudele	B u d_0Z E l E
vhudi	B u d_0Z i
vhudifari	B u d_0Z i f a r i
vhudifhinduleleli	B u d_0Z i p\ i n d u l E l E l i
vhudifhinduleli	B u d_0Z i p\ i n d u l E l i
vhudiimeseli	B u d_0Z i i m E s E l i
vhudiimiseli	B u d_0Z i i m i s E l i
vhudisa	B u d_0Z i s a
vhudokotela	B u d_0Z O k_> O t_> E l a
vhududo	B u d_0Z u d_0Z O
vhudza	B u dz a
vhudze	B u dz E
vhudzekani	B u dz E k_> a n i
vhudzhenelelani	B u dz h\ E n E l E l a n i
vhudzhenoni	B u dz h\ E n O n i
vhudzi	B u dz i
vhudziki	B u dz i k_> i
vhudzimu	B u dz i m u
vhudzisa	B u dz i s a
vhudzise	B u dz i s E
vhudzisea	B u dz i s E a
vhudzisesa	B u dz i s E s a
vhudziseswa	B u dz i s E sw a
vhudziswa	B u dz i sw a
vhudzivha	B u dz i B a
vhudziwa	B u dz i w a
vhudzula	B u dz u l a
vhudzulapo	B u dz u l a p_> O
vhudzulo	B u dz u l O
vhudzuloni	B u dz u l O n i
vhudzwa	B u dz w a
vhue	B u E
vhuedza	B u E dz a
vhuedzedza	B u E dz E dz a
vhuedzedzwa	B u E dz E dz w a
vhuelanaho	B u E l a n a h\ O
vhuelela	B u E l E l a
vhueletshedzi	B u E l E tS_h E dz i
vhuelwa	B u E l w a
vhuendedzi	B u E n d E dz i
vhuendelamashango	B u E n d E l a m a S a n g O
vhuendelamshango	B u E n d E l a m S a n g O
vhuendi	B u E n d i
vhuendisi	B u E n d i s i
vhufa	B u f a
vhufhinduleli	B u p\ i n d u l E l i
vhufhio	B u p\ i O
vhufhura	B u p\ u r a
vhufuli	B u f u l i
vhufumakadzi	B u f u m a k_> a dz i
vhufumi	B u f u m i
vhufuwi	B u f u w i
vhugai	B u g a i
vhugala	B u g a l a
vhugalaphukha	B u g a l a p_h u k_h a
vhugevhenga	B u g E B E n g a
vhugoni	B u g O n i
vhugudisi	B u g u d_0Z i s i
vhuhali	B u h\ a l i
vhuhanani	B u h\ a n a n i
vhuhaṱuli	B u h\ a t_> u l i
vhuhole	B u h\ O l E
vhuholefhali	B u h\ O l E p\ a l i
vhuhosi	B u h\ O s i
vhuhulu	B u h\ u l u
vhuhulwane	B u h\ u l w a n E
vhuhwarahwara	B u h\ w a r a h\ w a r a
vhui	B u i
vhuifari	B u i f a r i
vhuifhinduleli	B u i p\ i n d u l E l i
vhuiimo	B u i i m O
vhuiiti	B u i i t_> i
vhuiivhi	B u i i B i
vhuimabisi	B u i m a b i s i
vhuimana	B u i m a n a
vhuimangalavha	B u i m a n g a l a B a
vhuimeli	B u i m E l i
vhuimo	B u i m O
vhuimoni	B u i m O n i
vhuingameli	B u i n g a m E l i
vhuinzhinere	B u i n Z i n E r E
vhuisa	B u i s a
vhuisedza	B u i s E dz a
vhuisela	B u i s E l a
vhuisi	B u i s i
vhuiswa	B u i sw a
vhukale	B u k_> a l E
vhukando	B u k_> a n d O
vhukati	B u k_> a t_> i
vhukavhabufho	B u k_> a B a b u p\ O
vhukhakhi	B u k_h a k_h i
vhukhakhulili	B u k_h a k_h u l i l i
vhukhakhululi	B u k_h a k_h u l u l i
vhukhudo	B u k_h u d_0Z O
vhukoma	B u k_> O m a
vhukomani	B u k_> O m a n i
vhukonani	B u k_> O n a n i
vhukonanyi	B u k_> O n a J i
vhukoni	B u k_> O n i
vhukono	B u k_> O n O
vhukovhela	B u k_> O B E l a
vhukule	B u k_> u l E
vhukuma	B u k_> u m a
vhukunda	B u k_> u n d a
vhukuse	B u k_> u s E
vhukwamani	B u k_> w a m a n i
vhukwamiwa	B u k_> w a m i w a
vhukwanani	B u k_> w a n a n i
vhukwila	B u k_> w i l a
vhulaelwa	B u l a E l w a
vhulaha	B u l a h\ a
vhulahela	B u l a h\ E l a
vhulahwa	B u l a h\ w a
vhulaifa	B u l a i f a
vhulaiwa	B u l a i w a
vhulamukanyi	B u l a m u k_> a J i
vhulamuli	B u l a m u l i
vhulangea	B u l a n g E a
vhulangi	B u l a n g i
vhulanguli	B u l a n g u l i
vhulapfu	B u l a p_> f u
vhulaudzi	B u l a u dz i
vhulavhelese	B u l a B E l E s E
vhulavhelesi	B u l a B E l E s i
vhulawa	B u l a w a
vhulawanga	B u l a w a n g a
vhuleme	B u l E m E
vhulenda	B u l E n d a
vhulimi	B u l i m i
vhuloi	B u l O i
vhulondavhathu	B u l O n d a B a t_h u
vhulondo	B u l O n d O
vhulondoti	B u l O n d O t_> i
vhuludu	B u l u d_0Z u
vhululamisi	B u l u l a m i s i
vhululamisio	B u l u l a m i s i O
vhulunga	B u l u n g a
vhulunge	B u l u n g E
vhulungea	B u l u n g E a
vhulungeaho	B u l u n g E a h\ O
vhulungiwa	B u l u n g i w a
vhulungwa	B u l u n g w a
vhulungwaho	B u l u n g w a h\ O
vhuluvha	B u l u B a
vhuluvhi	B u l u B i
vhuluvhisi	B u l u B i s i
vhulwadze	B u l w a dz E
vhumagi	B u m a g i
vhumalo	B u m a l O
vhumatshelo	B u m a tS_h E l O
vhumba	B u m b a
vhumbaho	B u m b a h\ O
vhumbani	B u m b a n i
vhumbe	B u m b E
vhumbindudzi	B u m b i n d u dz i
vhumbiwa	B u m b i w a
vhumbiwaho	B u m b i w a h\ O
vhumbwa	B u m b w a
vhumvumvusi	B u m v u m v u s i
vhundeme	B u n d E m E
vhune	B u n E
vhunga	B u n g a
vhungafhani	B u n g a p\ a n i
vhungana	B u n g a n a
vhungoho	B u n g O h\ O
vhungomu	B u n g O m u
vhunna	B u n n a
vhunwe	B u n w E
vhunzani	B u n z a n i
vhunzhi	B u n Z i
vhunzhisa	B u n Z i s a
vhunḓu	B u n d u
vhunṋe	B u n n E
vhuoli	B u O l i
vhuongeloni	B u O n g E l O n i
vhuongi	B u O n g i
vhupfa	B u p_> f a
vhupfelo	B u p_> f E l O
vhupfimbi	B u p_> f i m b i
vhupfiwa	B u p_> f i w a
vhupfuluwi	B u p\ f u l u w i
vhupfumedzani	B u p_> f u m E dz a n i
vhupfumedzanyi	B u p_> f u m E dz a J i
vhuphara	B u p_h a r a
vhupikisani	B u p_> i k_> i s a n i
vhupileli	B u p_> i l E l i
vhupo	B u p_> O
vhupombwe	B u p_> O m b w E
vhupondi	B u p_> O n d i
vhuponi	B u p_> O n i
vhupulani	B u p_> u l a n i
vhura	B u r a
vhurangaphanda	B u r a n g a p_h a n d a
vhurangaphanḓa	B u r a n g a p_h a n d a
vhurangeli	B u r a n g E l i
vhuraphanḓa	B u r a p_h a n d a
vhuraru	B u r a r u
vhureakhovhe	B u r E a k_h O B E
vhurendi	B u r E n d i
vhurereli	B u r E r E l i
vhuria	B u r i a
vhurifhi	B u r i p\ i
vhuriha	B u r i h\ a
vhuronwane	B u r O n w a n E
vhurufhi	B u r u p\ i
vhurumelwa	B u r u m E l w a
vhurumiwa	B u r u m i w a
vhurwa	B u r w a
vhusa	B u s a
vhusaho	B u s a h\ O
vhusai	B u s a i
vhusedzi	B u s E dz i
vhusekene	B u s E k_> E n E
vhusha	B u S a
vhushai	B u S a i
vhushaka	B u S a k_> a
vhushani	B u S a n i
vhushavhelo	B u S a B E l O
vhushaya	B u S a j a
vhushayahaya	B u S a j a h\ a j a
vhushayi	B u S a j i
vhushumeli	B u S u m E l i
vhushumisani	B u S u m i s a n i
vhusi	B u s i
vhusiki	B u s i k_> i
vhusiku	B u s i k_> u
vhusimama	B u s i m a m a
vhusimamaḓaka	B u s i m a m a d a k_> a
vhusimamilayo	B u s i m a m i l a j O
vhusimamiri	B u s i m a m i r i
vhusiwana	B u s i w a n a
vhusumbe	B u s u m b E
vhut	B u t_>
vhutala	B u t_> a l a
vhutali	B u t_> a l i
vhutanu	B u t_> a n u
vhutanzi	B u t_> a n z i
vhutea	B u t_> E a
vhutengu	B u t_> E n g u
vhuthathatshili	B u t_h a t_h a tS_h i l i
vhuthihi	B u t_h i h\ i
vhuthogwa	B u t_h O g w a
vhuthomi	B u t_h O m i
vhuthu	B u t_h u
vhutodisisi	B u t_> O d_0Z i s i s i
vhutoisisi	B u t_> O i s i s i
vhutshilo	B u tS_h i l O
vhutshiloni	B u tS_h i l O n i
vhutshimbidzi	B u tS_h i m b i dz i
vhutshinyi	B u tS_h i J i
vhutshivha	B u tS_h i B a
vhutshutshisi	B u tS_h u tS_h i s i
vhutsila	B u ts_> i l a
vhutsilu	B u ts_> i l u
vhutsireledzi	B u ts_> i r E l E dz i
vhutuka	B u t_> u k_> a
vhutukani	B u t_> u k_> a n i
vhutumani	B u t_> u m a n i
vhutumanyi	B u t_> u m a J i
vhutumbukisi	B u t_> u m b u k_> i s i
vhutumbuli	B u t_> u m b u l i
vhutungu	B u t_> u n g u
vhuuku	B u k_> u
vhuunḓi	B u n d i
vhuvemu	B u v E m u
vhuvha	B u B a
vhuvhambadzaseli	B u B a m b a dz a s E l i
vhuvhambadzelaseli	B u B a m b a dz E l a s E l i
vhuvhambadzi	B u B a m b a dz i
vhuvhava	B u B a v a
vhuvhaḓi	B u B a d i
vhuvhi	B u B i
vhuvhili	B u B i l i
vhuvhusi	B u B u s i
vhuwe	B u w E
vhuya	B u j a
vhuyaho	B u j a h\ O
vhuye	B u j E
vhuyedzedzwa	B u j E dz E dz w a
vhuyela	B u j E l a
vhuyelela	B u j E l E l a
vhuyo	B u j O
vhuḓalo	B u d a l O
vhuḓe	B u d E
vhuḓi	B u d i
vhuḓifari	B u d i f a r i
vhuḓifhindulei	B u d i p\ i n d u l E i
vhuḓifhindulele	B u d i p\ i n d u l E l E
vhuḓifhinduleli	B u d i p\ i n d u l E l i
vhuḓifulufheli	B u d i f u l u p\ E l i
vhuḓiimiseli	B u d i i m i s E l i
vhuḓilangi	B u d i l a n g i
vhuḓipfi	B u d i p_> f i
vhuḓiṅwalisi	B u d i n w a l i s i
vhuḽa	B u l a
vhuṅe	B u N E
vhuṅwali	B u n w a l i
vhuṅwalisi	B u n w a l i s i
vhuṅwe	B u n w E
vhuṋa	B u n a
vhuṋe	B u n E
vhuṋwe	B u n w E
vhuṱala	B u t_> a l a
vhuṱali	B u t_> a l i
vhuṱama	B u t_> a m a
vhuṱambo	B u t_> a m b O
vhuṱanzi	B u t_> a n z i
vhuṱanzu	B u t_> a n z u
vhuṱasana	B u t_> a s a n a
vhuṱhogwa	B u t_h O g w a
vhuṱoḓisisi	B u t_> O d i s i s i
vhuṱudzeṱudze	B u t_> u dz E t_> u dz E
vhuṱuku	B u t_> u k_> u
vhuṱumani	B u t_> u m a n i
vhuṱun	B u t_> u n
vhuṱundi	B u t_> u n d i
vhuṱungu	B u t_> u n g u
via	v a E
via	v i a
video	v i d_0Z E O
video	v i d E E
vidio	v i d_0Z i O
viela	v i E l a
vip	v i p_>
visa	v i s a
visa	v i z E
vivho	v i B O
viya	v i j a
viḽeini	v i l E i n i
vndi	v i E n d i a
vo	v O
voho	v O h\ O
vondwe	v O n d w E
voni	v O n i
vothi	v O t_h i
vouta	v O u t_> a
voutha	v O u t_h a
vouthu	v O u t_h u
voutu	v O u t_> u
vula	v u l a
vulani	v u l a n i
vule	v u l E
vuledze	v u l E dz E
vuledzwa	v u l E dz w a
vulelwa	v u l E l w a
vuleyaho	v u l E j a h\ O
vulwa	v u l w a
vun	v u n
vund	v u n d
vunddu	v u n d d_0Z u
vundea	v u n d E a
vundu	v u n d u
vunu	v u n u
vunḓa	v u n d a
vunḓu	v u n d u
vusa	v u s a
vusuludza	v u s u l u dz a
vusuludzwa	v u s u l u dz w a
vusuluswa	v u s u l u sw a
vuvha	v u B a
vuwa	v u w a
vuṅdu	v u n d_0Z u
vuṋdu	v u n d_0Z u
wa	w a
wadi	O d a
wadi	w a d_0Z i
wadzo	w a dz O
waha	w a h\ a
waini	w a i n i
walani	w a l a n i
wale	w a l E
wale	w E l
walelwaho	w a l E l w a h\ O
wales	w a l E s
wales	w E l z
waliswa	w a l i sw a
waliswaho	w a l i sw a h\ O
waliwa	w a l i w a
walo	w a l O
walt	w a l t_h
walwa	w a l w a
wambo	w a m b O
wana	w a n a
wanafhi	w a n a p\ i
wanaho	w a n a h\ O
wanala	w a n a l a
wanalaho	w a n a l a h\ O
wanale	w a n a l E
wanalea	w a n a l E a
wanalee	w a n a l E E
wanalei	w a n a l E i
wanalesa	w a n a l E s a
wananga	w a n a n g a
wanani	w a n a n i
wane	w a n E
wane	w E n
wanedza	w a n E dz a
wanela	w a n E l a
wanesa	w a n E s a
wanga	w a n g a
wani	w a n i
wanisisa	w a n i s i s a
wanisise	w a n i s i s E
waniwa	w a n i w a
waniwaho	w a n i w a h\ O
wanulula	w a n u l u l a
wanulusa	w a n u l u s a
wanwa	w a n w a
wanwaho	w a n w a h\ O
wapo	w a p_> O
war	w a r
war	w O r
waranthi	w a r a n t_h i
washo	w a S O
washu	w a S u
watch	w O tS_h
watsho	w a tS_h O
wau	w a u
wavho	w a B O
wavhudi	w a B u d_0Z i
wavhuḓi	w a B u d i
wawe	w a w E
wawo	w a w O
wayo	w a j O
waṋu	w a n u
waṋuwe	w a n u w E
we	w E
we	w i
web	w E b
website	w E b s a t_h
website	w E b s i t_> E
webusaithi	w E b u s a i t_h i
wedza	w E dz a
wedzwa	w E dz w a
wee	w E E
wee	w i
wela	w E l a
welaho	w E l a h\ O
wele	w E l E
welelele	w E l E l E l E
welwaho	w E l w a h\ O
wessels	w E s E l z
wessels	w E s s E l s
west	w E s t_>
west	w E s t_h
western	w E s t_> E r n
western	w E s t_h E n
wetshela	w E tS_h E l a
wetshelaho	w E tS_h E l a h\ O
wheat	w E a t_>
wheat	w i t_h
white	w a t_h
white	w i t_> E
wide	w a d
wide	w i d_0Z E
wildlife	w a l d l a f
wildlife	w i l d_0Z l i f E
wili	w i l i
wina	w i n a
winiwa	w i n i w a
winners	w E n E z
winners	w i n n E r s
winning	w E n i N
winning	w i n n i n g
wipo	w a p_h O
wipo	w i p_> O
wisa	w i s a
wo	w O
wone	w O n E
wongo	w O n g O
wonoyo	w O n O j O
world	w a l d
world	w O r l d_0Z
wothe	w O t_h E
wovha	w O B a
woṱhe	w O t_h E
writer	r a t_h E r
writer	w r i t_> E r
writers	r a t_h E z
writers	w r i t_> E r s
wua	w u a
x	E k_h s
xedza	x E dz a
xedzaho	x E dz a h\ O
xela	x E l a
xelaho	x E l a h\ O
xelelwa	x E l E l w a
ya	j a
yaho	j a h\ O
yalwo	j a l w O
yan	j a n
yanga	j a n g a
yannu	j a n n u
yanu	j a n u
yao	j a O
yapo	j a p_> O
yashavha	j a S a B a
yashu	j a S u
yatsho	j a tS_h O
yau	j a u
yavha	j a B a
yavho	j a B O
yavhud	j a B u d_0Z
yavhudi	j a B u d_0Z i
yavhui	j a B u i
yavhuḓi	j a B u d i
yawe	j a w E
yawo	j a w O
yayo	j a j O
yazwihoḓoni	j a zw i h\ O d O n i
yazwo	j a zw O
yaḽo	j a l O
yaṋu	j a n u
ye	j E
ye	j i
years	j a z
years	j E a r s
yela	j E l a
yelana	j E l a n a
yelanaho	j E l a n a h\ O
yelanho	j E l a n O
yelaniho	j E l a n i h\ O
yenei	j E n E i
yeneyo	j E n E j O
yi	j i
yo	j O
yogathi	j O g a t_h i
yohe	j O h\ E
yone	j O n E
yongo	j O n g O
york	j O k_h
york	j O r k_>
yotanganaho	j O t_> a n g a n a h\ O
yothe	j O t_h E
yoṱhe	j O t_h E
yunifomo	j u n i f O m O
yunithi	j u n i t_h i
yuniti	j u n i t_> i
yunivesithi	j u n i v E s i t_h i
yuropa	j u r O p_> a
z	z E t_h
z	z i
zealand	z E a l a n d
zealand	z i l E n d
zhalinga	Z a l i n g a
zhamba	Z a m b a
zhendedzhi	Z E n d E dz h\ i
zhendedzi	Z E n d E dz i
zhenedzi	Z E n E dz i
zimbabwe	z E m b a b w E
zimbabwe	z i m b a b w E
zwa	zw a
zwadzo	zw a dz O
zwaho	zw a h\ O
zwala	zw a l a
zwalo	zw a l O
zwana	zw a n a
zwanga	zw a n g a
zwanḓa	zw a n d a
zwao	zw a O
zwapo	zw a p_> O
zwashu	zw a S u
zwatsho	zw a tS_h O
zwauri	zw a u r i
zwavho	zw a B O
zwavhu	zw a B u
zwavhud	zw a B u d_0Z
zwavhudi	zw a B u d_0Z i
zwavhui	zw a B u i
zwavhuḓi	zw a B u d i
zwawe	zw a w E
zwayo	zw a j O
zwazwino	zw a zw i n O
zwazwo	zw a zw O
zwaḽo	zw a l O
zwe	zw E
zwenezwi	zw E n E zw i
zwenezwino	zw E n E zw i n O
zwenezwo	zw E n E zw O
zwi	zw i
zwiambaro	zw i a m b a r O
zwibadela	zw i b a d_0Z E l a
zwibampuni	zw i b a m p_> u n i
zwibogisi	zw i b O g i s i
zwibokoṱo	zw i b O k_> O t_> O
zwibugwana	zw i b u g w a n a
zwibveledzwa	zw i b v E l E dz w a
zwibveledzwaho	zw i b v E l E dz w a h\ O
zwidimela	zw i d_0Z i m E l a
zwidodombedzwa	zw i d_0Z O d_0Z O m b E dz w a
zwidodombodzwa	zw i d_0Z O d_0Z O m b O dz w a
zwidongo	zw i d_0Z O n g O
zwidzidzivhadzi	zw i dz i dz i B a dz i
zwidzimamulilo	zw i dz i m a m u l i l O
zwidzimba	zw i dz i m b a
zwidzimula	zw i dz i m u l a
zwidzivhadzi	zw i dz i B a dz i
zwiendedzi	zw i E n d E dz i
zwiendisi	zw i E n d i s i
zwifani	zw i f a n i
zwifanyiso	zw i f a J i s O
zwifha	zw i p\ a
zwifhao	zw i p\ a O
zwifhato	zw i p\ a t_> O
zwifhatuwo	zw i p\ a t_> u w O
zwifhaṱo	zw i p\ a t_> O
zwifhaṱuwo	zw i p\ a t_> u w O
zwifhaṱuwoni	zw i p\ a t_> u w O n i
zwifhela	zw i p\ E l a
zwifhelela	zw i p\ E l E l a
zwifhinga	zw i p\ i n g a
zwifhio	zw i p\ i O
zwifhiwa	zw i p\ i w a
zwifho	zw i p\ O
zwifuiwa	zw i f u i w a
zwifuwo	zw i f u w O
zwiga	zw i g a
zwiganḓiswa	zw i g a n d i sw a
zwigidi	zw i g i d_0Z i
zwigili	zw i g i l i
zwigombela	zw i g O m b E l a
zwigoḓo	zw i g O d O
zwigwa	zw i g w a
zwigwada	zw i g w a d_0Z a
zwihali	zw i h\ a l i
zwiho	zw i h\ O
zwihoda	zw i h\ O d_0Z a
zwihoḓoni	zw i h\ O d O n i
zwihulu	zw i h\ u l u
zwihuluhulu	zw i h\ u l u h\ u l u
zwihulusa	zw i h\ u l u s a
zwihulwane	zw i h\ u l w a n E
zwiiimo	zw i i i m O
zwiimiswa	zw i i m i sw a
zwiitisi	zw i i t_> i s i
zwiito	zw i i t_> O
zwiiwa	zw i i w a
zwikalo	zw i k_> a l O
zwikambi	zw i k_> a m b i
zwikene	zw i k_> E n E
zwikhala	zw i k_h a l a
zwikhathi	zw i k_h a t_h i
zwikho	zw i k_h O
zwikhokhonono	zw i k_h O k_h O n O n O
zwikhoḓo	zw i k_h O d O
zwikhukhulisi	zw i k_h u k_h u l i s i
zwikili	zw i k_> i l i
zwikimu	zw i k_> i m u
zwiko	zw i k_> O
zwikolo	zw i k_> O l O
zwikolodo	zw i k_> O l O d_0Z O
zwikolodoni	zw i k_> O l O d_0Z O n i
zwikoloni	zw i k_> O l O n i
zwikona	zw i k_> O n a
zwikumedzwa	zw i k_> u m E dz w a
zwilakati	zw i l a k_> a t_> i
zwilidzo	zw i l i dz O
zwililo	zw i l i l O
zwilimi	zw i l i m i
zwiliwa	zw i l i w a
zwiliṅwa	zw i l i n w a
zwilonda	zw i l O n d a
zwima	zw i m a
zwimba	zw i m b a
zwimela	zw i m E l a
zwina	zw i n a
zwinamana	zw i n a m a n a
zwinamelwa	zw i n a m E l w a
zwine	zw i n E
zwinepe	zw i n E p_> E
zwinga	zw i n g a
zwingafha	zw i n g a p\ a
zwingafhani	zw i n g a p\ a n i
zwino	zw i n O
zwinungo	zw i n u n g O
zwinwe	zw i n w E
zwinwiwa	zw i n w i w a
zwinzhi	zw i n Z i
zwiori	zw i O r i
zwipaipi	zw i p_> a i p_> i
zwipentsisi	zw i p_> E n ts_> i s i
zwipfi	zw i p_> f i
zwiphiri	zw i p_h i r i
zwiphuga	zw i p_h u g a
zwipia	zw i p_> i a
zwipida	zw i p_> i d_0Z a
zwipidi	zw i p_> i d_0Z i
zwipikwa	zw i p_> i k_> w a
zwipiri	zw i p_> i r i
zwipiḓa	zw i p_> i d a
zwipondwa	zw i p_> O n d w a
zwipotso	zw i p_> O ts_> O
zwipuka	zw i p_> u k_> a
zwiraru	zw i r a r u
zwire	zw i r E
zwirengwa	zw i r E n g w a
zwisekene	zw i s E k_> E n E
zwishumisa	zw i S u m i s a
zwishumiswa	zw i S u m i sw a
zwisikwa	zw i s i k_> w a
zwisilaidi	zw i s i l a i d_0Z i
zwiswa	zw i sw a
zwitangeni	zw i t_> a n g E n i
zwitangini	zw i t_> a n g i n i
zwitatamennde	zw i t_> a t_> a m E n n d E
zwitenwa	zw i t_> E n w a
zwiteṅwa	zw i t_> E n w a
zwithavhani	zw i t_h a B a n i
zwithithisi	zw i t_h i t_h i s i
zwithu	zw i t_h u
zwitirathedzhi	zw i t_> i r a t_h E dz h\ i
zwitiriki	zw i t_> i r i k_> i
zwitshakatshaka	zw i tS_h a k_> a tS_h a k_> a
zwitshavha	zw i tS_h a B a
zwitshavhano	zw i tS_h a B a n O
zwitshele	zw i tS_h E l E
zwitshili	zw i tS_h i l i
zwitsivhudzi	zw i ts_> i B u dz i
zwituku	zw i t_> u k_> u
zwitumbu	zw i t_> u m b u
zwiuku	zw i u k_> u
zwivhambadzwann	zw i B a m b a dz w a n n
zwivhanda	zw i B a n d a
zwivhaswa	zw i B a sw a
zwivhili	zw i B i l i
zwivhumbeo	zw i B u m b E O
zwivhuya	zw i B u j a
zwiwe	zw i w E
zwiwo	zw i w O
zwizwala	zw i zw a l a
zwiḓivha	zw i d i B a
zwiḽiwa	zw i l i w a
zwiḽiwani	zw i l i w a n i
zwiḽiwapfushi	zw i l i w a p_> f u S i
zwiṅwe	zw i n w E
zwiṋwe	zw i n w E
zwiṱangani	zw i t_> a n g a n i
zwiṱefu	zw i t_> E f u
zwiṱirathedzhi	zw i t_> i r a t_h E dz h\ i
zwiṱitshi	zw i t_> i tS_h i
zwiṱo	zw i t_> O
zwiṱuku	zw i t_> u k_> u
zwiṱukuṱuku	zw i t_> u k_> u t_> u k_> u
zwiṱunḓwa	zw i t_> u n d w a
zwo	zw O
zwohe	zw O h\ E
zwondolola	zw O n d O l O l a
zwone	zw O n E
zwonezwi	zw O n E zw i
zwothe	zw O t_h E
zwoṱhe	zw O t_h E
zwpikwa	zw p_> i k_> w a
zwṅwe	zw n w E
ḓ	d
ḓa	d a
ḓadza	d a dz a
ḓadze	d a dz E
ḓadzi	d a dz i
ḓadzisa	d a dz i s a
ḓadziswa	d a dz i sw a
ḓadziwa	d a dz i w a
ḓadziwaho	d a dz i w a h\ O
ḓadzwa	d a dz w a
ḓadzwaho	d a dz w a h\ O
ḓafula	d a f u l a
ḓaganana	d a g a n a n a
ḓaho	d a h\ O
ḓaka	d a k_> a
ḓakani	d a k_> a n i
ḓala	d a l a
ḓalelwa	d a l E l w a
ḓalesa	d a l E s a
ḓana	d a n a
ḓavha	d a B a
ḓaḓa	d a d a
ḓaḓisaho	d a d i s a h\ O
ḓaḓisi	d a d i s i
ḓe	d E
ḓea	d E a
ḓeaho	d E a h\ O
ḓela	d E l a
ḓelwa	d E l w a
ḓembe	d E m b E
ḓere	d E r E
ḓewleaho	d E w l E a h\ O
ḓhohoni	d O h\ O n i
ḓi	d i
ḓibvisa	d i b v i s a
ḓibvise	d i b v i s E
ḓidina	d i d_0Z i n a
ḓidoswole	d i d_0Z O sw O l E
ḓidzhenisa	d i dz h\ E n i s a
ḓidzhieni	d i dz h\ i E n i
ḓidzima	d i dz i m a
ḓifara	d i f a r a
ḓifha	d i p\ a
ḓifhaho	d i p\ a h\ O
ḓifhe	d i p\ E
ḓifhi	d i p\ i
ḓifuna	d i f u n a
ḓigeḓa	d i g E d a
ḓihudza	d i h\ u dz a
ḓihwa	d i h\ w a
ḓihwala	d i h\ w a l a
ḓiimisa	d i i m i s a
ḓiimisaho	d i i m i s a h\ O
ḓiimisela	d i i m i s E l a
ḓiimiselaho	d i i m i s E l a h\ O
ḓikanzwa	d i k_> a n zw a
ḓikhethela	d i k_h E t_h E l a
ḓikumedzela	d i k_> u m E dz E l a
ḓila	d i l a
ḓilondota	d i l O n d O t_> a
ḓinekedza	d i n E k_> E dz a
ḓipfe	d i p_> f E
ḓipfisa	d i p_> f i s a
ḓipfumisa	d i p_> f u m i s a
ḓiphina	d i p_h i n a
ḓiphine	d i p_h i n E
ḓiraibva	d i r a i b v a
ḓiraiva	d i r a i v a
ḓirama	d i r a m a
ḓiresi	d i r E s i
ḓirwana	d i r w a n a
ḓisa	d i s a
ḓisendedza	d i s E n d E dz a
ḓisendeka	d i s E n d E k_> a
ḓisendekaho	d i s E n d E k_> a h\ O
ḓisisa	d i s i s a
ḓisiso	d i s i s O
ḓiswaho	d i sw a h\ O
ḓithusa	d i t_h u s a
ḓitika	d i t_> i k_> a
ḓitikaho	d i t_> i k_> a h\ O
ḓitonda	d i t_> O n d a
ḓitsireledza	d i ts_> i r E l E dz a
ḓivha	d i B a
ḓivhadza	d i B a dz a
ḓivhadzana	d i B a dz a n a
ḓivhadze	d i B a dz E
ḓivhadzwa	d i B a dz w a
ḓivhadzwaho	d i B a dz w a h\ O
ḓivhadzwi	d i B a dz w i
ḓivhaho	d i B a h\ O
ḓivhamaipfi	d i B a m a i p_> f i
ḓivhana	d i B a n a
ḓivhani	d i B a n i
ḓivhashango	d i B a S a n g O
ḓivhazwakale	d i B a zw a k_> a l E
ḓivhe	d i B E
ḓivhea	d i B E a
ḓivheaho	d i B E a h\ O
ḓivhei	d i B E i
ḓivhelwa	d i B E l w a
ḓivhelwaho	d i B E l w a h\ O
ḓivhi	d i B i
ḓivhiga	d i B i g a
ḓivhiho	d i B i h\ O
ḓivhisa	d i B i s a
ḓivhona	d i B O n a
ḓivhonadza	d i B O n a dz a
ḓivhuisa	d i B u i s a
ḓiwana	d i w a n a
ḓiwanela	d i w a n E l a
ḓiḓivhadze	d i d i B a dz E
ḓiṅwalisa	d i n w a l i s a
ḓiṋekedza	d i n E k_> E dz a
ḓiṋetshedza	d i n E tS_h E dz a
ḓiṋwalisela	d i n w a l i s E l a
ḓiṱama	d i t_> a m a
ḓiṱanganedza	d i t_> a n g a n E dz a
ḓiṱongisa	d i t_> O n g i s a
ḓo	d O
ḓola	d O l a
ḓongololo	d O n g O l O l O
ḓongololothavha	d O n g O l O l O t_h a B a
ḓorobo	d O r O b O
ḓoroboni	d O r O b O n i
ḓowela	d O w E l a
ḓoweleaho	d O w E l E a h\ O
ḓowetsumo	d O w E ts_> u m O
ḓu	d u
ḓuri	d u r i
ḓuriho	d u r i h\ O
ḓuvha	d u B a
ḓwa	d w a
ḽ	l
ḽa	l a
ḽaborathori	l a b O r a t_h O r i
ḽadi	l a d_0Z i
ḽaho	l a h\ O
ḽaibrari	l a i b r a r i
ḽaiburari	l a i b u r a r i
ḽaisa	l a i s a
ḽaisensti	l a i s E n s t_> i
ḽaisentse	l a i s E n ts_> E
ḽaisentsi	l a i s E n ts_> i
ḽanga	l a n g a
ḽanu	l a n u
ḽaseintsi	l a s E i n ts_> i
ḽashu	l a S u
ḽauthoma	l a u t_h O m a
ḽavho	l a B O
ḽavhuraru	l a B u r a r u
ḽavhuvhili	l a B u B i l i
ḽawe	l a w E
ḽayo	l a j O
ḽaḽo	l a l O
ḽaṋu	l a n u
ḽe	l E
ḽee	l E E
ḽeibu	l E i b u
ḽene	l E n E
ḽenelo	l E n E l O
ḽeneo	l E n E O
ḽeneḽo	l E n E l O
ḽengisa	l E n g i s a
ḽeve	l E v E
ḽi	l i
ḽia	l i a
ḽibulafhethu	l i b u l a p\ E t_h u
ḽidza	l i dz a
ḽidzela	l i dz E l a
ḽifanyisi	l i f a J i s i
ḽifhasi	l i p\ a s i
ḽifurase	l i f u r a s E
ḽiga	l i g a
ḽigegise	l i g E g i s E
ḽihoro	l i h\ O r O
ḽihulu	l i h\ u l u
ḽihulwane	l i h\ u l w a n E
ḽiiti	l i i t_> i
ḽikumedzwa	l i k_> u m E dz w a
ḽilapfu	l i l a p_> f u
ḽiluvha	l i l u B a
ḽimagi	l i m a g i
ḽimudi	l i m u d_0Z i
ḽindele	l i n d E l E
ḽine	l i n E
ḽino	l i n O
ḽinwalo	l i n w a l O
ḽinwe	l i n w E
ḽiselwa	l i s E l w a
ḽisi	l i s i
ḽiswa	l i sw a
ḽithihi	l i t_h i h\ i
ḽitibutibu	l i t_> i b u t_> i b u
ḽitswu	l i ts_> w u
ḽivhili	l i B i l i
ḽivhusi	l i B u s i
ḽivi	l i v i
ḽiwa	l i w a
ḽiwi	l i w i
ḽiṅwalo	l i n w a l O
ḽiṅwe	l i n w E
ḽiṋwalo	l i n w a l O
ḽiṋwe	l i n w E
ḽiṱuku	l i t_> u k_> u
ḽo	l O
ḽoan	l O a n
ḽone	l O n E
ḽora	l O r a
ḽothe	l O t_h E
ḽounu	l O u n u
ḽova	l O v a
ḽoṱhe	l O t_h E
ḽu	l u
ḽwa	l w a
ṅ	n
ṅanda	n a n d a
ṅanga	n a n g a
ṅangani	n a n g a n i
ṅea	N E a
ṅeane	N E a n E
ṅekedza	N E k_> E dz a
ṅekedzwa	N E k_> E dz w a
ṅetshedza	N E tS_h E dz a
ṅetshedzwa	N E tS_h E dz w a
ṅewaho	N E w a h\ O
ṅwaha	N w a h\ a
ṅwahafumi	N w a h\ a f u m i
ṅwala	n w a l a
ṅwalani	n w a l a n i
ṅwalaḽo	n w a l a l O
ṅwale	n w a l E
ṅwalela	n w a l E l a
ṅwalelani	n w a l E l a n i
ṅwalelwa	n w a l E l w a
ṅwalisa	n w a l i s a
ṅwalisaho	n w a l i s a h\ O
ṅwalise	n w a l i s E
ṅwaliselaho	n w a l i s E l a h\ O
ṅwaliselwaho	n w a l i s E l w a h\ O
ṅwalisi	n w a l i s i
ṅwalisiwaho	n w a l i s i w a h\ O
ṅwaliswa	n w a l i sw a
ṅwaliswaho	n w a l i sw a h\ O
ṅwaliwa	n w a l i w a
ṅwaliwaho	n w a l i w a h\ O
ṅwalo	n w a l O
ṅwalwa	n w a l w a
ṅwalwaho	n w a l w a h\ O
ṅwambo	N w a m b O
ṅwana	N w a n a
ṅwananga	N w a n a n g a
ṅwananyana	N w a n a J a n a
ṅwe	N w E
ṅwedzi	N w E dz i
ṅwethuwa	N w E t_h u w a
ṅweṅwela	n w E n w E l a
ṅwongo	N w O n g O
ṋ	n
ṋama	n a m a
ṋambara	n a m b a r a
ṋambi	n a m b i
ṋamusi	n a m u s i
ṋanga	n a n g a
ṋawa	n a w a
ṋaṅwaha	n a n w a h\ a
ṋaṋa	n a n a
ṋaṋisana	n a n i s a n a
ṋda	n d_0Z a
ṋdila	n d_0Z i l a
ṋdivho	n d_0Z i B O
ṋea	n E a
ṋeaho	n E a h\ O
ṋeana	n E a n a
ṋee	n E E
ṋeeni	n E E n i
ṋeiwa	n E i w a
ṋekana	n E k_> a n a
ṋekane	n E k_> a n E
ṋekedza	n E k_> E dz a
ṋekedze	n E k_> E dz E
ṋekedzela	n E k_> E dz E l a
ṋekedzwa	n E k_> E dz w a
ṋekedzwaho	n E k_> E dz w a h\ O
ṋekekza	n E k_> E k_> z a
ṋetshedza	n E tS_h E dz a
ṋetshedzo	n E tS_h E dz O
ṋetshedzomaa	n E tS_h E dz O m a a
ṋetshedzomaanda	n E tS_h E dz O m a a n d a
ṋetshedzwa	n E tS_h E dz w a
ṋetshedzwaho	n E tS_h E dz w a h\ O
ṋewa	n E w a
ṋewaho	n E w a h\ O
ṋna	n n a
ṋne	n n E
ṋombaro	n O m b a r O
ṋombora	n O m b O r a
ṋomboro	n O m b O r O
ṋotshi	n O tS_h i
ṋwaha	n w a h\ a
ṋwalisela	n w a l i s E l a
ṋwaliselwa	n w a l i s E l w a
ṋwana	n w a n a
ṋwedzi	n w E dz i
ṱ	t_>
ṱa	t_> a
ṱahaho	t_> a h\ a h\ O
ṱahe	t_> a h\ E
ṱahedza	t_> a h\ E dz a
ṱahedzwa	t_> a h\ E dz w a
ṱahela	t_> a h\ E l a
ṱahisa	t_> a h\ i s a
ṱahiswa	t_> a h\ i sw a
ṱahiswaho	t_> a h\ i sw a h\ O
ṱalaho	t_> a l a h\ O
ṱalana	t_> a l a n a
ṱalela	t_> a l E l a
ṱali	t_> a l i
ṱalifha	t_> a l i p\ a
ṱalifhaho	t_> a l i p\ a h\ O
ṱalukanya	t_> a l u k_> a J a
ṱalulwa	t_> a l u l w a
ṱalusa	t_> a l u s a
ṱalusiwa	t_> a l u s i w a
ṱalutshadza	t_> a l u tS_h a dz a
ṱalutshedza	t_> a l u tS_h E dz a
ṱalutshedzaho	t_> a l u tS_h E dz a h\ O
ṱalutshedze	t_> a l u tS_h E dz E
ṱalutshedzwa	t_> a l u tS_h E dz w a
ṱama	t_> a m a
ṱamaṱisi	t_> a m a t_> i s i
ṱamba	t_> a m b a
ṱambaho	t_> a m b a h\ O
ṱana	t_> a n a
ṱanangedza	t_> a n a n g E dz a
ṱandavhuwaho	t_> a n d a B u w a h\ O
ṱangana	t_> a n g a n a
ṱanganedza	t_> a n g a n E dz a
ṱanganedzaho	t_> a n g a n E dz a h\ O
ṱanganedzana	t_> a n g a n E dz a n a
ṱanganedzeaho	t_> a n g a n E dz E a h\ O
ṱanganedzwa	t_> a n g a n E dz w a
ṱanganedzwaho	t_> a n g a n E dz w a h\ O
ṱanganedzwe	t_> a n g a n E dz w E
ṱanganelana	t_> a n g a n E l a n a
ṱanganelanaho	t_> a n g a n E l a n a h\ O
ṱanganelano	t_> a n g a n E l a n O
ṱanganya	t_> a n g a J a
ṱanganyelwa	t_> a n g a J E l w a
ṱanganyisa	t_> a n g a J i s a
ṱanganyiswa	t_> a n g a J i sw a
ṱanganyiswaho	t_> a n g a J i sw a h\ O
ṱanganywa	t_> a n g a J w a
ṱangaṋwa	t_> a n g a n w a
ṱangulwa	t_> a n g u l w a
ṱanzi	t_> a n z i
ṱanziela	t_> a n z i E l a
ṱanzielaho	t_> a n z i E l a h\ O
ṱanzielwa	t_> a n z i E l w a
ṱanzilelwa	t_> a n z i l E l w a
ṱanzwa	t_> a n zw a
ṱanḓavhudza	t_> a n d a B u dz a
ṱanḓavhuwa	t_> a n d a B u w a
ṱapanyedza	t_> a p_> a J E dz a
ṱapanyedzwa	t_> a p_> a J E dz w a
ṱari	t_> a r i
ṱatshilelwa	t_> a tS_h i l E l w a
ṱavha	t_> a B a
ṱavhanya	t_> a B a J a
ṱavhanyaho	t_> a B a J a h\ O
ṱavhanye	t_> a B a J E
ṱavhanyedza	t_> a B a J E dz a
ṱavhanyesa	t_> a B a J E s a
ṱavhanyezwa	t_> a B a J E zw a
ṱavhanyisa	t_> a B a J i s a
ṱavhe	t_> a B E
ṱavhiwa	t_> a B i w a
ṱaḓulu	t_> a d u l u
ṱaṱa	t_> a t_> a
ṱaṱisana	t_> a t_> i s a n a
ṱe	t_> E
ṱela	t_> E l a
ṱempiwa	t_> E m p_> i w a
ṱempiwe	t_> E m p_> i w E
ṱhaha	t_h a h\ a
ṱhahelelo	t_h a h\ E l E l O
ṱhahwa	t_h a h\ w a
ṱhalano	t_h a l a n O
ṱhalutshedzo	t_h a l u tS_h E dz O
ṱhamu	t_h a m u
ṱhanga	t_h a n g a
ṱhanganathukhu	t_h a n g a n a t_h u k_h u
ṱhanganelano	t_h a n g a n E l a n O
ṱhangule	t_h a n g u l E
ṱhanu	t_h a n u
ṱhanzi	t_h a n z i
ṱhanziela	t_h a n z i E l a
ṱhanzimakone	t_h a n z i m a k_> O n E
ṱhanzwa	t_h a n zw a
ṱhaphudzapfunzo	t_h a p_h u dz a p_> f u n z O
ṱhavha	t_h a B a
ṱhavhana	t_h a B a n a
ṱhavhanyiso	t_h a B a J i s O
ṱhavhela	t_h a B E l a
ṱhavhiwa	t_h a B i w a
ṱhaṱhuvha	t_h a t_h u B a
ṱhaṱhuvho	t_h a t_h u B O
ṱhingo	t_h i n g O
ṱhingothendeleki	t_h i n g O t_h E n d E l E k_> i
ṱhirakha	t_h i r a k_h a
ṱhirakhani	t_h i r a k_h a n i
ṱhisedzo	t_h i s E dz O
ṱho	t_h O
ṱhodea	t_h O d_0Z E a
ṱhodisiso	t_h O d_0Z i s i s O
ṱhodzi	t_h O dz i
ṱhogomela	t_h O g O m E l a
ṱhogomele	t_h O g O m E l E
ṱhogomelo	t_h O g O m E l O
ṱhoho	t_h O h\ O
ṱhohoyanḓou	t_h O h\ O j a n d O u
ṱhompha	t_h O m p_h a
ṱhompho	t_h O m p_h O
ṱhoni	t_h O n i
ṱhonifha	t_h O n i p\ a
ṱhonifhana	t_h O n i p\ a n a
ṱhonifhi	t_h O n i p\ i
ṱhonifhiwa	t_h O n i p\ i w a
ṱhonifho	t_h O n i p\ O
ṱhonipho	t_h O n i p_h O
ṱhoḓea	t_h O d E a
ṱhoḓisio	t_h O d i s i O
ṱhoḓisiso	t_h O d i s i s O
ṱhu	t_h u
ṱhuhwa	t_h u h\ w a
ṱhukhu	t_h u k_h u
ṱhukhufhadzo	t_h u k_h u p\ a dz O
ṱhungu	t_h u n g u
ṱhungulifha	t_h u n g u l i p\ a
ṱhuwedzo	t_h u w E dz O
ṱhuṱhuwedzo	t_h u t_h u w E dz O
ṱira	t_> i r a
ṱiraka	t_> i r a k_> a
ṱisano	t_> i s a n O
ṱo	t_> O
ṱokaho	t_> O k_> a h\ O
ṱola	t_> O l a
ṱolani	t_> O l a n i
ṱolela	t_> O l E l a
ṱoliwa	t_> O l i w a
ṱolwa	t_> O l w a
ṱorokisi	t_> O r O k_> i s i
ṱoḓa	t_> O d a
ṱoḓaho	t_> O d a h\ O
ṱoḓea	t_> O d E a
ṱoḓeaho	t_> O d E a h\ O
ṱoḓee	t_> O d E E
ṱoḓei	t_> O d E i
ṱoḓi	t_> O d i
ṱoḓisisa	t_> O d i s i s a
ṱoḓisise	t_> O d i s i s E
ṱoḓiwaho	t_> O d i w a h\ O
ṱoḓou	t_> O d O u
ṱoḓwa	t_> O d w a
ṱoṱomodza	t_> O t_> O m O dz a
ṱshi	t_> S i
ṱshitafu	t_> S i t_> a f u
ṱu	t_> u
ṱuku	t_> u k_> u
ṱumanya	t_> u m a J a
ṱumetshedzwaho	t_> u m E tS_h E dz w a h\ O
ṱun	t_> u n
ṱungufhadza	t_> u n g u p\ a dz a
ṱungufhala	t_> u n g u p\ a l a
ṱusa	t_> u s a
ṱuswa	t_> u sw a
ṱutshela	t_> u tS_h E l a
ṱutshele	t_> u tS_h E l E
ṱuvha	t_> u B a
ṱuwa	t_> u w a
ṱuwani	t_> u w a n i
ṱuwe	t_> u w E
ṱuwedza	t_> u w E dz a
ṱuwi	t_> u w i
ṱuṅwa	t_> u n w a
ṱuṱula	t_> u t_> u l a
ṱuṱulaho	t_> u t_> u l a h\ O
ṱuṱule	t_> u t_> u l E
ṱuṱulea	t_> u t_> u l E a
ṱuṱuwedza	t_> u t_> u w E dz a
ṱuṱuwedzaho	t_> u t_> u w E dz a h\ O
ṱuṱuwedziwa	t_> u t_> u w E dz i w a
ṱuṱuwedzwa	t_> u t_> u w E dz w a
ṱwa	t_> w a
